AGGAGTTGGAGGGTGGCGC -> GGAGTTGGAGGGTGGCGCT
GACGTGTTGGCGATTGACC -> ACGTGTTGGCGATTGACCG
GGGTCGTTAAGCCCCCATT -> GGTCGTTAAGCCCCCATTA
AACATTTACCCGCATCTAG -> ACATTTACCCGCATCTAGT
TTCATGTCATTACATTGGA -> TCATGTCATTACATTGGAC
TTTGGGTGCGTACAATATC -> TTGGGTGCGTACAATATCA
CACGGACCTGATCGCACAG -> ACGGACCTGATCGCACAGG
GTATATACAACTTTGGGTG -> TATATACAACTTTGGGTGC
TGCCGATGTGCGGTGATCT -> GCCGATGTGCGGTGATCTG
CCTTTCGCTACCTCGCGCG -> CTTTCGCTACCTCGCGCGT
TCTTCTGCTCCAAATTGCT -> CTTCTGCTCCAAATTGCTT,CTTCTGCTCCAAATTGCTT,CTTCTGCTCCAAATTGCTG,CTTCTGCTCCAAATTGCTT
GTACGTAAGTCCAACCTCG -> TACGTAAGTCCAACCTCGG
GGGCTCATCATTAGGCATT -> GGCTCATCATTAGGCATTC
GATTTTTCTCACCTTGTCA -> ATTTTTCTCACCTTGTCAC
AACCGGGGCGGATGAAAGA -> ACCGGGGCGGATGAAAGAG
TGTACGTAAGTCCAACCTC -> GTACGTAAGTCCAACCTCG
ATTCATCACACACCAGTCT -> TTCATCACACACCAGTCTT
CTTGAGTGGAGGTAGTGTT -> TTGAGTGGAGGTAGTGTTG
CGCAACAAACGCCGTGATT -> GCAACAAACGCCGTGATTC
TTGATGTCCCAAATCCCGC -> TGATGTCCCAAATCCCGCA
TTGTGTAGCAACAGTTGGC -> TGTGTAGCAACAGTTGGCA
AATCTCTTCTGCTCCAAAT -> ATCTCTTCTGCTCCAAATT
AATTGCTTAGTGCGGGCGG -> ATTGCTTAGTGCGGGCGGC
CTTCCCGTATTGTCCGATA -> TTCCCGTATTGTCCGATAG
TGATGTGGGCTGTTTGCTC -> GATGTGGGCTGTTTGCTCC
ATGCCTTGAAGAAGGTGTC -> TGCCTTGAAGAAGGTGTCT
ATATCCGCTGCTGACGGTG -> TATCCGCTGCTGACGGTGG
CCTATTCCGCATCGATTGG -> CTATTCCGCATCGATTGGG
TGGCACAGCGGGGGCGCTC -> GGCACAGCGGGGGCGCTCT
TCGCGCGTCGGGTAACTAT -> CGCGCGTCGGGTAACTATC
CAGAAACGTTAGCAATCGC -> AGAAACGTTAGCAATCGCT
CTTCTGCTCCAAATTGCTG -> TTCTGCTCCAAATTGCTGA
GTTGCTCTTGTATAAGGTC -> TTGCTCTTGTATAAGGTCA
TAACAAGCGGAGCAAAGCA -> AACAAGCGGAGCAAAGCAG
CCACCAACTAGACTGCTCC -> CACCAACTAGACTGCTCCG
CAGTATTGTAGTAGAGGGA -> AGTATTGTAGTAGAGGGAG
GAAATGTAGACGAAACTAT -> AAATGTAGACGAAACTATT
TATTAACCCGGTCCAGAAA -> ATTAACCCGGTCCAGAAAC
TGAAGAAGGTGTCTCGGAG -> GAAGAAGGTGTCTCGGAGC
GTTTCTGCTGTTTCTCGGT -> TTTCTGCTGTTTCTCGGTA
CCCGCATCTAGTGATGCCG -> CCGCATCTAGTGATGCCGG
CGTGGCGGTATATACAACT -> GTGGCGGTATATACAACTT
CCGGACCACCTTCAACTTC -> CGGACCACCTTCAACTTCT
GTTTTGGTCCCCCCGAGTT -> TTTTGGTCCCCCCGAGTTA
TCGGTGGAAAGACTCAGTA -> CGGTGGAAAGACTCAGTAG
GGCGATTGACCGCTAACTT -> GCGATTGACCGCTAACTTT
GCAACAGTTGGCACAGCGG -> CAACAGTTGGCACAGCGGG
CGTCCAACAACATCACCGG -> GTCCAACAACATCACCGGA
CAGCGCCATGACGGTAGAG -> AGCGCCATGACGGTAGAGG
GGGGCGGATGAAAGAGATT -> GGGCGGATGAAAGAGATTC
GTCTCGGAGCTAACTGATC -> TCTCGGAGCTAACTGATCT
TAAGGTCACTGCTTCGATA -> AAGGTCACTGCTTCGATAA
CACCGGGCGGAGCGCAAGG -> ACCGGGCGGAGCGCAAGGT
ATGAATGACTACTCGGCCA -> TGAATGACTACTCGGCCAT
GCTGATGATCCGCCAACCT -> CTGATGATCCGCCAACCTC
GGGCAACAAATATCCGCTG -> GGCAACAAATATCCGCTGC
GCGCAGCGGAACATCTTCG -> CGCAGCGGAACATCTTCGT
CATGTCATTACATTGGACG -> ATGTCATTACATTGGACGT
CGATGTGGCTACTCATCGC -> GATGTGGCTACTCATCGCT
AGCTCGGAAGCCTCGGTTC -> GCTCGGAAGCCTCGGTTCA
GATCGTAAAGCCACCAACT -> ATCGTAAAGCCACCAACTA
CGGTGACAGTTCTGACTAA -> GGTGACAGTTCTGACTAAG
CTGAATCAGTATTGTAGTA -> TGAATCAGTATTGTAGTAG
ATACGTTAGCAACTGGACA -> TACGTTAGCAACTGGACAT
CTAGTGATGCCGGTACGCT -> TAGTGATGCCGGTACGCTT
GATTCGTCGCGATCACGAG -> ATTCGTCGCGATCACGAGC
ACACCAGTCTTACAGCGCC -> CACCAGTCTTACAGCGCCA
CCGGTCCAGAAACGTTAGC -> CGGTCCAGAAACGTTAGCA
CGTTAGCAACTGGACATCA -> GTTAGCAACTGGACATCAA
AAAGCGTGTGTATACAATC -> AAGCGTGTGTATACAATCG
CGGTAGGGTACTATCGAGC -> GGTAGGGTACTATCGAGCA
ACCAGTCTTACAGCGCCAT -> CCAGTCTTACAGCGCCATG
GAGCGGAGACGATCGGAGT -> AGCGGAGACGATCGGAGTA
AGAGATTCATCACACACCA -> GAGATTCATCACACACCAG
CGGATGAAAGAGATTCATC -> GGATGAAAGAGATTCATCA
TCTTGAGGGGTTCTCTGGG -> CTTGAGGGGTTCTCTGGGT
TGCGAGTGGGCATAAAAAA -> GCGAGTGGGCATAAAAAAT
TCAACTACGCCGCCGGTAA -> CAACTACGCCGCCGGTAAA
TACGCTTTCTGTAGCAACA -> ACGCTTTCTGTAGCAACAG
CTCATCGCTGGTGTTCGAA -> TCATCGCTGGTGTTCGAAT
TCCGCCAACCTCGAGTGGC -> CCGCCAACCTCGAGTGGCC
ATTGCTTAGTGCGGGCGGC -> TTGCTTAGTGCGGGCGGCC
GCGGTTGGTGTCGTGGCGG -> CGGTTGGTGTCGTGGCGGT
AGGGTGTTCCCATTTGATT -> GGGTGTTCCCATTTGATTT
TCGGAGCTAACTGATCTCT -> CGGAGCTAACTGATCTCTT
CAAACTTCATGTCATTACA -> AAACTTCATGTCATTACAT
CTGAGGGCTGGGCCTTTTA -> TGAGGGCTGGGCCTTTTAA
TTCCCATTTGATTTTGTTT -> TCCCATTTGATTTTGTTTC
CTTTCTGTAGCAACAGTTG -> TTTCTGTAGCAACAGTTGG
CATATGACAATATTTGTTT -> ATATGACAATATTTGTTTC
TGAAAAGGCCTCTAGGGCT -> GAAAAGGCCTCTAGGGCTG
CCAAATTGCTTAAGTCACA -> CAAATTGCTTAAGTCACAC
TTTTAAGGATGTAGCAACA -> TTTAAGGATGTAGCAACAG
GACCGCTAACTTTCGGACG -> ACCGCTAACTTTCGGACGG
CGGACCTGATCGCACAGGA -> GGACCTGATCGCACAGGAG
ATCTGGGGGCAGCCATGAA -> TCTGGGGGCAGCCATGAAT
TACTCGGCCATACGTTAGC -> ACTCGGCCATACGTTAGCA
TGGTGTTCGAATCGGATTT -> GGTGTTCGAATCGGATTTT
GACATCAACTACGCCGCCG -> ACATCAACTACGCCGCCGG
GCATCGATTGGGTCGTTAA -> CATCGATTGGGTCGTTAAG
CCGTCACCGAGCACCCCAA -> CGTCACCGAGCACCCCAAA
CGTTAGCAATCGCTGAATC -> GTTAGCAATCGCTGAATCA
GCTGGGCCTTTTAAGGATG -> CTGGGCCTTTTAAGGATGT
TCCGGACCACCTTCAACTT -> CCGGACCACCTTCAACTTC
AAAACCCTCTTCCCGTATT -> AAACCCTCTTCCCGTATTG
GCACTCGCTAGAGACCTTT -> CACTCGCTAGAGACCTTTC
TCTCAGATTTAGTTCGCGA -> CTCAGATTTAGTTCGCGAA
GGCTTGGCACCCAGTTGCC -> GCTTGGCACCCAGTTGCCA
AGCTAACTGATCTCTTGAG -> GCTAACTGATCTCTTGAGG
GAAAGAGATTCATCACACA -> AAAGAGATTCATCACACAC
CCTTGAAGAAGGTGTCTCG -> CTTGAAGAAGGTGTCTCGG
CGTCGGGTAACTATCCGTA -> GTCGGGTAACTATCCGTAC
CTGTTTGCTCCGGAGTGGG -> TGTTTGCTCCGGAGTGGGC
TAGCAATCGCTGAATCAGT -> AGCAATCGCTGAATCAGTA
AAGACTCAGTAGTATGCTG -> AGACTCAGTAGTATGCTGC
CAGGCTGATGATCCGCCAA -> AGGCTGATGATCCGCCAAC
TGCCGGCCCTCAACGTGCG -> GCCGGCCCTCAACGTGCGA
CTCTTCTGCTCCAAATTGC -> TCTTCTGCTCCAAATTGCT,TCTTCTGCTCCAAATTGCT
TTCATCACACACCAGTCTT -> TCATCACACACCAGTCTTA
AATCTATCCACACTTTCGA -> ATCTATCCACACTTTCGAT
ACATTTACCCGCATCTAGT -> CATTTACCCGCATCTAGTG
CTGCTCCGGGTACGTTGGG -> TGCTCCGGGTACGTTGGGC
TTAACTAAAATCGAAACTC -> TAACTAAAATCGAAACTCG
CCCTATTCCGCATCGATTG -> CCTATTCCGCATCGATTGG
CCTTGTCACCACGGACCTG -> CTTGTCACCACGGACCTGA
CCTCGGCTCTGATGTGGGC -> CTCGGCTCTGATGTGGGCT
ACCTTGGCCAATAATTTTT -> CCTTGGCCAATAATTTTTG
CAGCGGGGGCGCTCTTCTG -> AGCGGGGGCGCTCTTCTGC
GTAGCAACAGTTGGCACTG -> TAGCAACAGTTGGCACTGG
TAACGAAGATCGCGTAACA -> AACGAAGATCGCGTAACAA
AGAGGGAGCTGAGGGCTGG -> GAGGGAGCTGAGGGCTGGG
TCTTCCCGTATTGTCCGAT -> CTTCCCGTATTGTCCGATA
TCGCTGAATCAGTATTGTA -> CGCTGAATCAGTATTGTAG
TCTACTTTGCGGTCCACAA -> CTACTTTGCGGTCCACAAG
GATGTCCCAAATCCCGCAG -> ATGTCCCAAATCCCGCAGG
CTCAGTAGTATGCTGCCGG -> TCAGTAGTATGCTGCCGGC
AATTGCTTCCAGCCAGGGG -> ATTGCTTCCAGCCAGGGGT
ACATCTCGCCTTTGATGTC -> CATCTCGCCTTTGATGTCC
CCGTATTGTCCGATAGACG -> CGTATTGTCCGATAGACGC
CAACCTCGGCTCTGATGTG -> AACCTCGGCTCTGATGTGG
AGCAACAGTTGGCACGAGT -> GCAACAGTTGGCACGAGTT
ACTCGTTTCCCACTTGATC -> CTCGTTTCCCACTTGATCG
ATCGAGCACTCTAACACAC -> TCGAGCACTCTAACACACA
ACATCAATAACATTTACCC -> CATCAATAACATTTACCCG
GCAACAAATATCCGCTGCT -> CAACAAATATCCGCTGCTG
CCAATCACGTGATCTTCGG -> CAATCACGTGATCTTCGGT
GCTGGTGTTCGAATCGGAT -> CTGGTGTTCGAATCGGATT
CAAGTGTCGCGATGCCTTG -> AAGTGTCGCGATGCCTTGA
CGATTGACCGCTAACTTTC -> GATTGACCGCTAACTTTCG
GTAGACGAAACTATTAACC -> TAGACGAAACTATTAACCC
CTTAGGAGTTGGAGGGTGG -> TTAGGAGTTGGAGGGTGGC
AACAGTTGGCACAGCGGGG -> ACAGTTGGCACAGCGGGGG
TTCCATACTAACCTTGGCC -> TCCATACTAACCTTGGCCA
TCATCATTAGGCATTCGAT -> CATCATTAGGCATTCGATT
CAGACCTAGAGCTATGGGG -> AGACCTAGAGCTATGGGGT
GGTGTACGTAAGTCCAACC -> GTGTACGTAAGTCCAACCT
GGTAACCGTCACCGAGCAC -> GTAACCGTCACCGAGCACC
TCAGTAGTATGCTGCCGGC -> CAGTAGTATGCTGCCGGCC
TTTGATTTTGTTTCTGCTG -> TTGATTTTGTTTCTGCTGT
TGGATGTGGGTCCTTAGGA -> GGATGTGGGTCCTTAGGAG
TGAATCTAGTCCGCCTTGT -> GAATCTAGTCCGCCTTGTC
AACCCGGTCCAGAAACGTT -> ACCCGGTCCAGAAACGTTA
ACAGTTGGCACCTTTAATA -> CAGTTGGCACCTTTAATAA
TTCGGTGGAAAGACTCAGT -> TCGGTGGAAAGACTCAGTA
GTGGACCAATCACGTGATC -> TGGACCAATCACGTGATCT
ACGTGATCTTCGGTGACAG -> CGTGATCTTCGGTGACAGT
CCTTTTAAGGATGTAGCAA -> CTTTTAAGGATGTAGCAAC
TTTGTGTAGCAACAGTTGG -> TTGTGTAGCAACAGTTGGC
ACTCAGTAGTATGCTGCCG -> CTCAGTAGTATGCTGCCGG
GGTAAACTAGTCTCGTTTT -> GTAAACTAGTCTCGTTTTG
GACTGCTCCGGGTACGTTG -> ACTGCTCCGGGTACGTTGG
ATCTGGATGTGGGTCCTTA -> TCTGGATGTGGGTCCTTAG
TTTGCTCCGGAGTGGGCAA -> TTGCTCCGGAGTGGGCAAG
GGCTGAAATGTAGACGAAA -> GCTGAAATGTAGACGAAAC
CTTGTAGCAACAGTTGGCA -> TTGTAGCAACAGTTGGCAC
CGCGATGCCTTGAAGAAGG -> GCGATGCCTTGAAGAAGGT
GTGCACTCGCTAGAGACCT -> TGCACTCGCTAGAGACCTT
TCCAAATTGCTTCCAGCCA -> CCAAATTGCTTCCAGCCAG
GAGCTATGGGGTTACAGCT -> AGCTATGGGGTTACAGCTA
CCGATATCCTTGTAGCAAC -> CGATATCCTTGTAGCAACA
ACGGTAGAGGACGATCTGG -> CGGTAGAGGACGATCTGGA
ATAAAAAATCAGACCTAGA -> TAAAAAATCAGACCTAGAG
GCAAGTGTCGCGATGCCTT -> CAAGTGTCGCGATGCCTTG
TCGCCTTATAAAACCCTCT -> CGCCTTATAAAACCCTCTT
AGCAACTGGACATCAACTA -> GCAACTGGACATCAACTAC
TAGACGAAACTATTAACCC -> AGACGAAACTATTAACCCG
AGGTAGTGTTGGTGGACCA -> GGTAGTGTTGGTGGACCAA
ATTCTGACATCAATAACAT -> TTCTGACATCAATAACATT
CAATTCCGTATGTATATAT -> AATTCCGTATGTATATATT
ATCGCGTAACAAATTCTCA -> TCGCGTAACAAATTCTCAG
CCACCTTCAACTTCTGGGG -> CACCTTCAACTTCTGGGGA
ACCTGGCGGTTGGTGTCGT -> CCTGGCGGTTGGTGTCGTG
CCGGTGTTAGCAATTCCGT -> CGGTGTTAGCAATTCCGTA
CTCGGTTCATTCCCTATTC -> TCGGTTCATTCCCTATTCC
GCCTTCCCCGTCCCAGGCA -> CCTTCCCCGTCCCAGGCAA
ACAGTAGATAATGATCACG -> CAGTAGATAATGATCACGG
ACCACCTTCAACTTCTGGG -> CCACCTTCAACTTCTGGGG
CCGGTAGTGATTCTACTTT -> CGGTAGTGATTCTACTTTG
AGTTGGAGGGTGGCGCTCA -> GTTGGAGGGTGGCGCTCAC
GCTTGGCACCCAGTTGCCA -> CTTGGCACCCAGTTGCCAT
CGGAGCAAAGCAGAAATTT -> GGAGCAAAGCAGAAATTTG
TTTGCCGATGTGCGGTGAT -> TTGCCGATGTGCGGTGATC
AATGATCACGGTAGGGTAC -> ATGATCACGGTAGGGTACT
CTGATCTCTTGAGGGGTTC -> TGATCTCTTGAGGGGTTCT
CTAAAATCGAAACTCGCCT -> TAAAATCGAAACTCGCCTT
GGATGCGTGGTCTTCTGCT -> GATGCGTGGTCTTCTGCTC
ACCGGGGCGGATGAAAGAG -> CCGGGGCGGATGAAAGAGA
TCCCTATTCCGCATCGATT -> CCCTATTCCGCATCGATTG
CACACCGCAACAAACGCCG -> ACACCGCAACAAACGCCGT
ACCTTGTCACCACGGACCT -> CCTTGTCACCACGGACCTG
GCACTGGATGCGTGGTCTT -> CACTGGATGCGTGGTCTTC
GTAGCAACAGTTGGCACCT -> TAGCAACAGTTGGCACCTT
ACCAATCACGTGATCTTCG -> CCAATCACGTGATCTTCGG
CTGACGGTGGCCGGTGTTA -> TGACGGTGGCCGGTGTTAG
GGCATAAAAAATCAGACCT -> GCATAAAAAATCAGACCTA
ACTGCTCCGGGTACGTTGG -> CTGCTCCGGGTACGTTGGG
CACTTGATCGTAAAGCCAC -> ACTTGATCGTAAAGCCACC
TTTCTGTAGCAACAGTTGG -> TTCTGTAGCAACAGTTGGC
CCGTCATATGACAATATTT -> CGTCATATGACAATATTTG
AACCTCGGCTCTGATGTGG -> ACCTCGGCTCTGATGTGGG
TAGTATGCTGCCGGCCCTC -> AGTATGCTGCCGGCCCTCA
TACAACTTTGGGTGCGTAC -> ACAACTTTGGGTGCGTACA
ATCGCTTCCACTCTGACAG -> TCGCTTCCACTCTGACAGA
CGCCGCCGGTAAACTAGTC -> GCCGCCGGTAAACTAGTCT
TTCGATGTGGCTACTCATC -> TCGATGTGGCTACTCATCG
ATTGTCCGATAGACGCTCA -> TTGTCCGATAGACGCTCAT
GCTCGGAAGCCTCGGTTCA -> CTCGGAAGCCTCGGTTCAT
CAAATCTATCCACACTTTC -> AAATCTATCCACACTTTCG
TAGGCGCCAAAGGCCCCAC -> AGGCGCCAAAGGCCCCACT
TCTGGATGTGGGTCCTTAG -> CTGGATGTGGGTCCTTAGG
TCATCGCCGCAGTTCTTTA -> CATCGCCGCAGTTCTTTAA
CCTCTAGGGCTGAAATGTA -> CTCTAGGGCTGAAATGTAG
CGAGCGGAGACGATCGGAG -> GAGCGGAGACGATCGGAGT
GGCCGGTGTTAGCAATTCC -> GCCGGTGTTAGCAATTCCG
TCTCGGAGCTAACTGATCT -> CTCGGAGCTAACTGATCTC
GTTGCCATTAGGCGCCAAA -> TTGCCATTAGGCGCCAAAG
CTGTTTCTCGGTAACCGTC -> TGTTTCTCGGTAACCGTCA
ACTGGATGCGTGGTCTTCT -> CTGGATGCGTGGTCTTCTG
AGCAAAGCAGAAATTTGCA -> GCAAAGCAGAAATTTGCAA
AGGACGATCTGGATGTGGG -> GGACGATCTGGATGTGGGT
TATCCGTACTGCCGATATC -> ATCCGTACTGCCGATATCC
TGTTGGCGATTGACCGCTA -> GTTGGCGATTGACCGCTAA
GTTGGCACAGCGGGGGCGC -> TTGGCACAGCGGGGGCGCT
ATACAACTTTGGGTGCGTA -> TACAACTTTGGGTGCGTAC
CCGCAGTTCTTTAACTAAA -> CGCAGTTCTTTAACTAAAA
ATCCGCCAACCTCGAGTGG -> TCCGCCAACCTCGAGTGGC
ATATCATGGTGAATCTAGT -> TATCATGGTGAATCTAGTC
TAGCAACAGTTGGCACCTT -> AGCAACAGTTGGCACCTTT
TCTGGGGAACAGTAGATAA -> CTGGGGAACAGTAGATAAT
CCGCCGGTAAACTAGTCTC -> CGCCGGTAAACTAGTCTCG
GCCTTTGATGTCCCAAATC -> CCTTTGATGTCCCAAATCC
CCGCAACAAACGCCGTGAT -> CGCAACAAACGCCGTGATT
CCCGTCCCAGGCAACCTGG -> CCGTCCCAGGCAACCTGGC
TTCCCCGTCCCAGGCAACC -> TCCCCGTCCCAGGCAACCT
TTGCTCTTGTATAAGGTCA -> TGCTCTTGTATAAGGTCAC
ATCTGCTGGCTTGGCACCC -> TCTGCTGGCTTGGCACCCA
CACAGGAGAACAACTCGGA -> ACAGGAGAACAACTCGGAA
CGGTGGAAAGACTCAGTAG -> GGTGGAAAGACTCAGTAGT
GCTCCAAATTGCTGACTGT -> CTCCAAATTGCTGACTGTT
TACATTGGACGTGTTGGCG -> ACATTGGACGTGTTGGCGA
AGATTCATCACACACCAGT -> GATTCATCACACACCAGTC
GATAAGGTTCCATACTAAC -> ATAAGGTTCCATACTAACC
GGCACAGCGGGGGCGCTCT -> GCACAGCGGGGGCGCTCTT
AATTCCGTATGTATATATT -> ATTCCGTATGTATATATTA
GCTCATCATTAGGCATTCG -> CTCATCATTAGGCATTCGA
TATAACAAGCGGAGCAAAG -> ATAACAAGCGGAGCAAAGC
AAGCCACCAACTAGACTGC -> AGCCACCAACTAGACTGCT
GAACAACTCGGAACAGACG -> AACAACTCGGAACAGACGC
TTCTGCTCCAAATTGCTTA -> TCTGCTCCAAATTGCTTAA,TCTGCTCCAAATTGCTTAG
GCGCTCACTGCCGATTCGT -> CGCTCACTGCCGATTCGTC
TCGGTTCATTCCCTATTCC -> CGGTTCATTCCCTATTCCG
CTGCCGATATCCTTGTAGC -> TGCCGATATCCTTGTAGCA
CAGCCATGAATGACTACTC -> AGCCATGAATGACTACTCG
CGGCCATACGTTAGCAACT -> GGCCATACGTTAGCAACTG
TTAGAGCCGCTTTGTGTAG -> TAGAGCCGCTTTGTGTAGC
ATTGACCGCTAACTTTCGG -> TTGACCGCTAACTTTCGGA
AACTAAAATCGAAACTCGC -> ACTAAAATCGAAACTCGCC
GCAACTGGACATCAACTAC -> CAACTGGACATCAACTACG
GACGAAACTATTAACCCGG -> ACGAAACTATTAACCCGGT
CGGTATATACAACTTTGGG -> GGTATATACAACTTTGGGT
AAATTTGCAAGCTCGGAAG -> AATTTGCAAGCTCGGAAGC
CAACTTCTGGGGAACAGTA -> AACTTCTGGGGAACAGTAG
CATTACGATCTGCTGGCTT -> ATTACGATCTGCTGGCTTG
TGCTGGCTTGGCACCCAGT -> GCTGGCTTGGCACCCAGTT
AAAATCGAAACTCGCCTTA -> AAATCGAAACTCGCCTTAT
AAAGGCCTCTAGGGCTGAA -> AAGGCCTCTAGGGCTGAAA
CACCGGAGTTCTGTGTCCC -> ACCGGAGTTCTGTGTCCCG
AAGTGTCGCGATGCCTTGA -> AGTGTCGCGATGCCTTGAA
TAGCAACAGTTGGCACGAG -> AGCAACAGTTGGCACGAGT
AACAAATATCCGCTGCTGA -> ACAAATATCCGCTGCTGAC
GTTTCTCGGTAACCGTCAC -> TTTCTCGGTAACCGTCACC
TCGCTACCTCGCGCGTCGG -> CGCTACCTCGCGCGTCGGG
ACCCAGTTGCCATTAGGCG -> CCCAGTTGCCATTAGGCGC
GTACGTTGGGCTATCTTAT -> TACGTTGGGCTATCTTATA
CTGCTGTTTCTCGGTAACC -> TGCTGTTTCTCGGTAACCG
CAGTTGGCACTGGATGCGT -> AGTTGGCACTGGATGCGTG
TCATTACATTGGACGTGTT -> CATTACATTGGACGTGTTG
ATAGACGCTCATATGAAAA -> TAGACGCTCATATGAAAAG
CCAGGGGTTGCTCTTGTAT -> CAGGGGTTGCTCTTGTATA
GGGGTTACAGCTAAGGGTG -> GGGTTACAGCTAAGGGTGT
CGGACGGCGCCGTGGATCT -> GGACGGCGCCGTGGATCTA
TGGCTTGGCACCCAGTTGC -> GGCTTGGCACCCAGTTGCC
TGGCACTGGATGCGTGGTC -> GGCACTGGATGCGTGGTCT
TAACAAATTCTCAGATTTA -> AACAAATTCTCAGATTTAG
CTCTAACACACACCGCAAC -> TCTAACACACACCGCAACA
TTGGGCTATCTTATAACAA -> TGGGCTATCTTATAACAAG
AATCTAGTCCGCCTTGTCT -> ATCTAGTCCGCCTTGTCTG
TTTTGCCGATGTGCGGTGA -> TTTGCCGATGTGCGGTGAT
TCTAGGGCTGAAATGTAGA -> CTAGGGCTGAAATGTAGAC
CTTATAAAACCCTCTTCCC -> TTATAAAACCCTCTTCCCG
CCCCACTCTTCCGGACCAC -> CCCACTCTTCCGGACCACC
TTAAGCCCCCATTACGATC -> TAAGCCCCCATTACGATCT
CAATATCATGGTGAATCTA -> AATATCATGGTGAATCTAG
CCAGTCTTACAGCGCCATG -> CAGTCTTACAGCGCCATGA
GTAACCGTCACCGAGCACC -> TAACCGTCACCGAGCACCC
ACTTTCGGACGGCGCCGTG -> CTTTCGGACGGCGCCGTGG
CCTTGGCCAATAATTTTTG -> CTTGGCCAATAATTTTTGC
GATCTGCTGGCTTGGCACC -> ATCTGCTGGCTTGGCACCC
CTTGATCGTAAAGCCACCA -> TTGATCGTAAAGCCACCAA
CCGTCCCAGGCAACCTGGC -> CGTCCCAGGCAACCTGGCG
GAGCTAACTGATCTCTTGA -> AGCTAACTGATCTCTTGAG
TACTAACCTTGGCCAATAA -> ACTAACCTTGGCCAATAAT
GCCGTGGATCTAGTCAAAT -> CCGTGGATCTAGTCAAATC
CGCTTTGTGTAGCAACAGT -> GCTTTGTGTAGCAACAGTT
TGTCTGGGCTCATCATTAG -> GTCTGGGCTCATCATTAGG
GTAAGTCCAACCTCGGCTC -> TAAGTCCAACCTCGGCTCT
CATCAACTACGCCGCCGGT -> ATCAACTACGCCGCCGGTA
TATCCTTGTAGCAACAGTT -> ATCCTTGTAGCAACAGTTG
AACAAGCGGAGCAAAGCAG -> ACAAGCGGAGCAAAGCAGA
CGTGTGTATACAATCGTCC -> GTGTGTATACAATCGTCCA
GAGGGCTGGGCCTTTTAAG -> AGGGCTGGGCCTTTTAAGG
GACCTGATCGCACAGGAGA -> ACCTGATCGCACAGGAGAA
GTCTTCTGCTCCAAATTGC -> TCTTCTGCTCCAAATTGCT
GTCGTGGCGGTATATACAA -> TCGTGGCGGTATATACAAC
TTGAAGAAGGTGTCTCGGA -> TGAAGAAGGTGTCTCGGAG
AACTAGACTGCTCCGGGTA -> ACTAGACTGCTCCGGGTAC
CATAAAAAATCAGACCTAG -> ATAAAAAATCAGACCTAGA
CTTTCGATGTGGCTACTCA -> TTTCGATGTGGCTACTCAT
ACGTGTTGGCGATTGACCG -> CGTGTTGGCGATTGACCGC
GGGGGCGCTCTTCTGCTCC -> GGGGCGCTCTTCTGCTCCA
CCGTTTTACCCAACGAGCG -> CGTTTTACCCAACGAGCGC
TAACTATCCGTACTGCCGA -> AACTATCCGTACTGCCGAT
CTATCGAGCACTCTAACAC -> TATCGAGCACTCTAACACA
TGTCTCGGAGCTAACTGAT -> GTCTCGGAGCTAACTGATC
TTGGCGATTGACCGCTAAC -> TGGCGATTGACCGCTAACT
AAAGCCACCAACTAGACTG -> AAGCCACCAACTAGACTGC
TGTTAGAGCCGCTTTGTGT -> GTTAGAGCCGCTTTGTGTA
TAAAATCGAAACTCGCCTT -> AAAATCGAAACTCGCCTTA
GAGTGGAGGTAGTGTTGGT -> AGTGGAGGTAGTGTTGGTG
ATCGCTGGTGTTCGAATCG -> TCGCTGGTGTTCGAATCGG
ACTGATCTCTTGAGGGGTT -> CTGATCTCTTGAGGGGTTC
CTGCTCCAAATTGCTGACT -> TGCTCCAAATTGCTGACTG
GAGCGCAGCGGAACATCTT -> AGCGCAGCGGAACATCTTC
TCGGTGACAGTTCTGACTA -> CGGTGACAGTTCTGACTAA
TCGTCGCGATCACGAGCGG -> CGTCGCGATCACGAGCGGA
AGCAATCGCTGAATCAGTA -> GCAATCGCTGAATCAGTAT
AGTCTCGTTTTGGTCCCCC -> GTCTCGTTTTGGTCCCCCC
AACAGTTGGCACTGGATGC -> ACAGTTGGCACTGGATGCG
ACCCTCTTCCCGTATTGTC -> CCCTCTTCCCGTATTGTCC
TGCTGTTTCTCGGTAACCG -> GCTGTTTCTCGGTAACCGT
TATCTTATAACAAGCGGAG -> ATCTTATAACAAGCGGAGC
CATTTACCCGCATCTAGTG -> ATTTACCCGCATCTAGTGA
CTTTCGGACGGCGCCGTGG -> TTTCGGACGGCGCCGTGGA
ATCTCTTGAGGGGTTCTCT -> TCTCTTGAGGGGTTCTCTG
TCCGGAGTGGGCAAGTGTC -> CCGGAGTGGGCAAGTGTCG
CACACCGGGCGGAGCGCAA -> ACACCGGGCGGAGCGCAAG
TACGTTAGCAACTGGACAT -> ACGTTAGCAACTGGACATC
ACTGTTAGAGCCGCTTTGT -> CTGTTAGAGCCGCTTTGTG
GTGTCTCGGAGCTAACTGA -> TGTCTCGGAGCTAACTGAT
GGTCTTCTGCTCCAAATTG -> GTCTTCTGCTCCAAATTGC
GATCACGGTAGGGTACTAT -> ATCACGGTAGGGTACTATC
TCTGCTCCAAATTGCTTCC -> CTGCTCCAAATTGCTTCCA
CGGAGCTAACTGATCTCTT -> GGAGCTAACTGATCTCTTG
AGTTGCCATTAGGCGCCAA -> GTTGCCATTAGGCGCCAAA
AGAGCCGCTTTGTGTAGCA -> GAGCCGCTTTGTGTAGCAA
CAACTCGGAACAGACGCCG -> AACTCGGAACAGACGCCGG
GACGCTCATATGAAAAGCG -> ACGCTCATATGAAAAGCGT
AAGGGCAACAAATATCCGC -> AGGGCAACAAATATCCGCT
AACTGGACATCAACTACGC -> ACTGGACATCAACTACGCC
CGCATCTAGTGATGCCGGT -> GCATCTAGTGATGCCGGTA
GATTCATCACACACCAGTC -> ATTCATCACACACCAGTCT
TGGCGGTTGGTGTCGTGGC -> GGCGGTTGGTGTCGTGGCG
CCATTTGATTTTGTTTCTG -> CATTTGATTTTGTTTCTGC
GATTGACCGCTAACTTTCG -> ATTGACCGCTAACTTTCGG
GACCTAGAGCTATGGGGTT -> ACCTAGAGCTATGGGGTTA
CGGGCGGCCAGCAACCGGG -> GGGCGGCCAGCAACCGGGG
GGCAACCTGGCGGTTGGTG -> GCAACCTGGCGGTTGGTGT
AGAAGGTGTCTCGGAGCTA -> GAAGGTGTCTCGGAGCTAA
TGACCGCTAACTTTCGGAC -> GACCGCTAACTTTCGGACG
AATAACATTTACCCGCATC -> ATAACATTTACCCGCATCT
AGGTCTCCGTCATATGACA -> GGTCTCCGTCATATGACAA
CCTTTGATGTCCCAAATCC -> CTTTGATGTCCCAAATCCC
CGAGTGGGCATAAAAAATC -> GAGTGGGCATAAAAAATCA
AATATCATGGTGAATCTAG -> ATATCATGGTGAATCTAGT
ATTCGATTTTTCTCACCTT -> TTCGATTTTTCTCACCTTG
GTCTGGGCTCATCATTAGG -> TCTGGGCTCATCATTAGGC
CGCAGTTCTTTAACTAAAA -> GCAGTTCTTTAACTAAAAT
GCAAGCTCGGAAGCCTCGG -> CAAGCTCGGAAGCCTCGGT
AGACCTTTCGCTACCTCGC -> GACCTTTCGCTACCTCGCG
GCTTAGTGCGGGCGGCCAG -> CTTAGTGCGGGCGGCCAGC
CCAGCCAGGGGTTGCTCTT -> CAGCCAGGGGTTGCTCTTG
TAACTGATCTCTTGAGGGG -> AACTGATCTCTTGAGGGGT
ACCCGCATCTAGTGATGCC -> CCCGCATCTAGTGATGCCG
GGACCTGATCGCACAGGAG -> GACCTGATCGCACAGGAGA
ACAATATTTGTTTCGGTGG -> CAATATTTGTTTCGGTGGA
AGAGCTATGGGGTTACAGC -> GAGCTATGGGGTTACAGCT
CCTCGAGTGGCCAGGTGTA -> CTCGAGTGGCCAGGTGTAC
CAACAGTTGGCACCTTTAA -> AACAGTTGGCACCTTTAAT
GTCCACAAGGGCAACAAAT -> TCCACAAGGGCAACAAATA
GGTGACAGTTCTGACTAAG -> GTGACAGTTCTGACTAAGC
TCCAAATTGCTTAGTGCGG -> CCAAATTGCTTAGTGCGGG
AGACTCAGTAGTATGCTGC -> GACTCAGTAGTATGCTGCC
TGTGCGGTGATCTGGGGGC -> GTGCGGTGATCTGGGGGCA
CACCGAGCACCCCAAACTT -> ACCGAGCACCCCAAACTTC
ACAGTTGGCACTGGATGCG -> CAGTTGGCACTGGATGCGT
TTAGTTCTTCTGCTCCAAA -> TAGTTCTTCTGCTCCAAAT
CGCATCGATTGGGTCGTTA -> GCATCGATTGGGTCGTTAA
TTCCGCATCGATTGGGTCG -> TCCGCATCGATTGGGTCGT
CGTCGCGATCACGAGCGGA -> GTCGCGATCACGAGCGGAG
TCTTCCGGACCACCTTCAA -> CTTCCGGACCACCTTCAAC
CTGGGCTCATCATTAGGCA -> TGGGCTCATCATTAGGCAT
CCCCCGAGTTATACTCGTT -> CCCCGAGTTATACTCGTTT
ACAGTTGGCACGAGTTATT -> CAGTTGGCACGAGTTATTA
CCAAACTTCATGTCATTAC -> CAAACTTCATGTCATTACA
TATCATGGTGAATCTAGTC -> ATCATGGTGAATCTAGTCC
TGCACTCGCTAGAGACCTT -> GCACTCGCTAGAGACCTTT
CCGAGCACCCCAAACTTCA -> CGAGCACCCCAAACTTCAT
AGGGGTTCTCTGGGTTCAT -> GGGGTTCTCTGGGTTCATC
TCAGATTTAGTTCGCGAAC -> CAGATTTAGTTCGCGAACA
TTCGGACGGCGCCGTGGAT -> TCGGACGGCGCCGTGGATC
CTTTCGCTACCTCGCGCGT -> TTTCGCTACCTCGCGCGTC
TCGGATTTTAAACCTTGAG -> CGGATTTTAAACCTTGAGT
AGCAACAGTTGGCACCTTT -> GCAACAGTTGGCACCTTTA
CTTCAACTTCTGGGGAACA -> TTCAACTTCTGGGGAACAG
GGCGCCAAAGGCCCCACTC -> GCGCCAAAGGCCCCACTCT
TTAGGAGTTGGAGGGTGGC -> TAGGAGTTGGAGGGTGGCG
GGCGCTCACTGCCGATTCG -> GCGCTCACTGCCGATTCGT
GACGATCGGAGTAACGAAG -> ACGATCGGAGTAACGAAGA
AAAAAATCAGACCTAGAGC -> AAAAATCAGACCTAGAGCT
CACTCGCTAGAGACCTTTC -> ACTCGCTAGAGACCTTTCG
TATTGTAGTAGAGGGAGCT -> ATTGTAGTAGAGGGAGCTG
GTCCCCCCGAGTTATACTC -> TCCCCCCGAGTTATACTCG
GATGTGCGGTGATCTGGGG -> ATGTGCGGTGATCTGGGGG
CGTCATATGACAATATTTG -> GTCATATGACAATATTTGT
GCGGTCCACAAGGGCAACA -> CGGTCCACAAGGGCAACAA
CCGCTAACTTTCGGACGGC -> CGCTAACTTTCGGACGGCG
AAATATCCGCTGCTGACGG -> AATATCCGCTGCTGACGGT
CGGCGCCGTGGATCTAGTC -> GGCGCCGTGGATCTAGTCA
TGGCACCCAGTTGCCATTA -> GGCACCCAGTTGCCATTAG
TTGCTCCGGAGTGGGCAAG -> TGCTCCGGAGTGGGCAAGT
CTGACATCAATAACATTTA -> TGACATCAATAACATTTAC
GGAACAGTAGATAATGATC -> GAACAGTAGATAATGATCA
TCCGTACTGCCGATATCCT -> CCGTACTGCCGATATCCTT
GCAACCGGGGCGGATGAAA -> CAACCGGGGCGGATGAAAG
CATACGTTAGCAACTGGAC -> ATACGTTAGCAACTGGACA
CATTTGATTTTGTTTCTGC -> ATTTGATTTTGTTTCTGCT
AGCGGGGGCGCTCTTCTGC -> GCGGGGGCGCTCTTCTGCT
TTTGTTTCTGCTGTTTCTC -> TTGTTTCTGCTGTTTCTCG
CAAATTGCTTAGTGCGGGC -> AAATTGCTTAGTGCGGGCG
ATTAGGCGCCAAAGGCCCC -> TTAGGCGCCAAAGGCCCCA
CGATACTGAAAAGGCCTCT -> GATACTGAAAAGGCCTCTA
TTTGATGTCCCAAATCCCG -> TTGATGTCCCAAATCCCGC
CATATGAAAAGCGTGTGTA -> ATATGAAAAGCGTGTGTAT
GGTGGACCAATCACGTGAT -> GTGGACCAATCACGTGATC
ATCATGGTGAATCTAGTCC -> TCATGGTGAATCTAGTCCG
GCAACAGTTGGCACTGGAT -> CAACAGTTGGCACTGGATG
GTTTTACCCAACGAGCGCA -> TTTTACCCAACGAGCGCAG
CACTCTAACACACACCGCA -> ACTCTAACACACACCGCAA
CAAATCCCGCAGGATCGCT -> AAATCCCGCAGGATCGCTT
AGTTGGCACTGGATGCGTG -> GTTGGCACTGGATGCGTGG
ACATCACCGGAGTTCTGTG -> CATCACCGGAGTTCTGTGT
TACAGCGCCATGACGGTAG -> ACAGCGCCATGACGGTAGA
CGCTAGAGACCTTTCGCTA -> GCTAGAGACCTTTCGCTAC
AAGCAGAAATTTGCAAGCT -> AGCAGAAATTTGCAAGCTC
TAACTAAAATCGAAACTCG -> AACTAAAATCGAAACTCGC
CAACGTGCGAGTGGGCATA -> AACGTGCGAGTGGGCATAA
AAAAGGCCTCTAGGGCTGA -> AAAGGCCTCTAGGGCTGAA
TTACCCGCATCTAGTGATG -> TACCCGCATCTAGTGATGC
TTGACCGCTAACTTTCGGA -> TGACCGCTAACTTTCGGAC
TAAGTCCAACCTCGGCTCT -> AAGTCCAACCTCGGCTCTG
AAGGTCTCCGTCATATGAC -> AGGTCTCCGTCATATGACA
CACAGCGGGGGCGCTCTTC -> ACAGCGGGGGCGCTCTTCT
TCACCTTGTCACCACGGAC -> CACCTTGTCACCACGGACC
TGATTTTGTTTCTGCTGTT -> GATTTTGTTTCTGCTGTTT
TGCTCCAAATTGCTTAGTG -> GCTCCAAATTGCTTAGTGC
ATGGGGTTACAGCTAAGGG -> TGGGGTTACAGCTAAGGGT
ACTCGGAACAGACGCCGGA -> CTCGGAACAGACGCCGGAA
TTGATCGTAAAGCCACCAA -> TGATCGTAAAGCCACCAAC
AGTTCTTTAACTAAAATCG -> GTTCTTTAACTAAAATCGA
TTCGGTGACAGTTCTGACT -> TCGGTGACAGTTCTGACTA
ATGACAATATTTGTTTCGG -> TGACAATATTTGTTTCGGT
CTAAGGGTGTTCCCATTTG -> TAAGGGTGTTCCCATTTGA
CTTGTCTGGGCTCATCATT -> TTGTCTGGGCTCATCATTA
CTTTGATGTCCCAAATCCC -> TTTGATGTCCCAAATCCCG
CTGGATGTGGGTCCTTAGG -> TGGATGTGGGTCCTTAGGA
CACGTGATCTTCGGTGACA -> ACGTGATCTTCGGTGACAG
CGTCCCAGGCAACCTGGCG -> GTCCCAGGCAACCTGGCGG
CTGCTCCAAATTGCTTCCA -> TGCTCCAAATTGCTTCCAG
TGCGGGCGGCCAGCAACCG -> GCGGGCGGCCAGCAACCGG
TCTGTGTCCCGGTAGTGAT -> CTGTGTCCCGGTAGTGATT
TCACCACGGACCTGATCGC -> CACCACGGACCTGATCGCA
ACTTTGGGTGCGTACAATA -> CTTTGGGTGCGTACAATAT
CTAGAGCTATGGGGTTACA -> TAGAGCTATGGGGTTACAG
GTGCGTACAATATCATGGT -> TGCGTACAATATCATGGTG
CCACGGACCTGATCGCACA -> CACGGACCTGATCGCACAG
CTTCTGCTCCAAATTGCTT -> TTCTGCTCCAAATTGCTTA,TTCTGCTCCAAATTGCTTA,TTCTGCTCCAAATTGCTTC
CGGAACATCTTCGTATTGG -> GGAACATCTTCGTATTGGT
GGATTTTAAACCTTGAGTG -> GATTTTAAACCTTGAGTGG
GACATCAATAACATTTACC -> ACATCAATAACATTTACCC
CCGTACTGCCGATATCCTT -> CGTACTGCCGATATCCTTG
GCGGAGCAAAGCAGAAATT -> CGGAGCAAAGCAGAAATTT
GCGCGTCGGGTAACTATCC -> CGCGTCGGGTAACTATCCG
GTCATTACATTGGACGTGT -> TCATTACATTGGACGTGTT
TTCTCGGTAACCGTCACCG -> TCTCGGTAACCGTCACCGA
ATCGAAACTCGCCTTATAA -> TCGAAACTCGCCTTATAAA
TGTCCCGGTAGTGATTCTA -> GTCCCGGTAGTGATTCTAC
CCGGTACGCTTTCTGTAGC -> CGGTACGCTTTCTGTAGCA
TCAACGTGCGAGTGGGCAT -> CAACGTGCGAGTGGGCATA
ATGTGGGTCCTTAGGAGTT -> TGTGGGTCCTTAGGAGTTG
GTTCATCGATACTGAAAAG -> TTCATCGATACTGAAAAGG
AGTTATACTCGTTTCCCAC -> GTTATACTCGTTTCCCACT
CAACTACGCCGCCGGTAAA -> AACTACGCCGCCGGTAAAC
TACCTCGCGCGTCGGGTAA -> ACCTCGCGCGTCGGGTAAC
CCCAAACTTCATGTCATTA -> CCAAACTTCATGTCATTAC
AGACGAAACTATTAACCCG -> GACGAAACTATTAACCCGG
TGCAAGCTCGGAAGCCTCG -> GCAAGCTCGGAAGCCTCGG
ATACTAACCTTGGCCAATA -> TACTAACCTTGGCCAATAA
GTCCGATAGACGCTCATAT -> TCCGATAGACGCTCATATG
CGATCTGGATGTGGGTCCT -> GATCTGGATGTGGGTCCTT
TCGATAAGGTTCCATACTA -> CGATAAGGTTCCATACTAA
CCCATTACGATCTGCTGGC -> CCATTACGATCTGCTGGCT
CTTTGGGTGCGTACAATAT -> TTTGGGTGCGTACAATATC
TGGTTGGTCATCGCCGCAG -> GGTTGGTCATCGCCGCAGT
CGATTTTTCTCACCTTGTC -> GATTTTTCTCACCTTGTCA
TAGTGCGGGCGGCCAGCAA -> AGTGCGGGCGGCCAGCAAC
TTCCGGACCACCTTCAACT -> TCCGGACCACCTTCAACTT
CGTAACAAATTCTCAGATT -> GTAACAAATTCTCAGATTT
GGTTCATTCCCTATTCCGC -> GTTCATTCCCTATTCCGCA
GTGATCTGGGGGCAGCCAT -> TGATCTGGGGGCAGCCATG
ATTCTCAGATTTAGTTCGC -> TTCTCAGATTTAGTTCGCG
GTTGGGCTATCTTATAACA -> TTGGGCTATCTTATAACAA
GCCGGAACGGGTGCACTCG -> CCGGAACGGGTGCACTCGC
AGAGCCCGTTTTACCCAAC -> GAGCCCGTTTTACCCAACG
TCACTGCCGATTCGTCGCG -> CACTGCCGATTCGTCGCGA
CCACACTTTCGATGTGGCT -> CACACTTTCGATGTGGCTA
GATCGCGTAACAAATTCTC -> ATCGCGTAACAAATTCTCA
GACTCAGTAGTATGCTGCC -> ACTCAGTAGTATGCTGCCG
TATACAATCGTCCAACAAC -> ATACAATCGTCCAACAACA
CGTATTGTCCGATAGACGC -> GTATTGTCCGATAGACGCT
AGTTGGCACGAGTTATTAG -> GTTGGCACGAGTTATTAGT
TGCCGATATCCTTGTAGCA -> GCCGATATCCTTGTAGCAA
TTAAACCTTGAGTGGAGGT -> TAAACCTTGAGTGGAGGTA
TAACCCGGTCCAGAAACGT -> AACCCGGTCCAGAAACGTT
TCTGCTCCAAATTGCTGAC -> CTGCTCCAAATTGCTGACT
CTCTGGGTTCATCGATACT -> TCTGGGTTCATCGATACTG
CAGTTGCCATTAGGCGCCA -> AGTTGCCATTAGGCGCCAA
GGGGAACAGTAGATAATGA -> GGGAACAGTAGATAATGAT
GCCGCCGGTAAACTAGTCT -> CCGCCGGTAAACTAGTCTC
TTTCGCTACCTCGCGCGTC -> TTCGCTACCTCGCGCGTCG
TGTTAGCAATTCCGTATGT -> GTTAGCAATTCCGTATGTA
AGTTCGCGAACATCTCGCC -> GTTCGCGAACATCTCGCCT
CTGGATGCGTGGTCTTCTG -> TGGATGCGTGGTCTTCTGC
TTTAATAATCTCTTCTGCT -> TTAATAATCTCTTCTGCTC
GCCCCCATTACGATCTGCT -> CCCCCATTACGATCTGCTG
CTGCTGACGGTGGCCGGTG -> TGCTGACGGTGGCCGGTGT
CCACTCTGACAGAGCCCGT -> CACTCTGACAGAGCCCGTT
ACCCAACGAGCGCAGCGGA -> CCCAACGAGCGCAGCGGAA
CATCGATACTGAAAAGGCC -> ATCGATACTGAAAAGGCCT
TGGGCTCATCATTAGGCAT -> GGGCTCATCATTAGGCATT
TCGCCGCAGTTCTTTAACT -> CGCCGCAGTTCTTTAACTA
CATGAATGACTACTCGGCC -> ATGAATGACTACTCGGCCA
GATTTTGTTTCTGCTGTTT -> ATTTTGTTTCTGCTGTTTC
TCACACACCAGTCTTACAG -> CACACACCAGTCTTACAGC
TTAGCAATTCCGTATGTAT -> TAGCAATTCCGTATGTATA
GCCTCTAGGGCTGAAATGT -> CCTCTAGGGCTGAAATGTA
TACCCAACGAGCGCAGCGG -> ACCCAACGAGCGCAGCGGA
TGGCGATTGACCGCTAACT -> GGCGATTGACCGCTAACTT
AGCGGAACATCTTCGTATT -> GCGGAACATCTTCGTATTG
CTGATCGCACAGGAGAACA -> TGATCGCACAGGAGAACAA
CGATGTGCGGTGATCTGGG -> GATGTGCGGTGATCTGGGG
TGATCGCACAGGAGAACAA -> GATCGCACAGGAGAACAAC
TAGTTCGCGAACATCTCGC -> AGTTCGCGAACATCTCGCC
GCGAGTGGGCATAAAAAAT -> CGAGTGGGCATAAAAAATC
CGCCGTGATTCTGACATCA -> GCCGTGATTCTGACATCAA
ACGATCGGAGTAACGAAGA -> CGATCGGAGTAACGAAGAT
AGTATTGTAGTAGAGGGAG -> GTATTGTAGTAGAGGGAGC
TTGCGGTCCACAAGGGCAA -> TGCGGTCCACAAGGGCAAC
GGGCTGTTTGCTCCGGAGT -> GGCTGTTTGCTCCGGAGTG
GATTGGGTCGTTAAGCCCC -> ATTGGGTCGTTAAGCCCCC
CAGGCAACCTGGCGGTTGG -> AGGCAACCTGGCGGTTGGT
AGCAGAAATTTGCAAGCTC -> GCAGAAATTTGCAAGCTCG
GGCCCTCAACGTGCGAGTG -> GCCCTCAACGTGCGAGTGG
AGCGCAAGGTCTCCGTCAT -> GCGCAAGGTCTCCGTCATA
CCGGAACGGGTGCACTCGC -> CGGAACGGGTGCACTCGCT
CGGTGGCCGGTGTTAGCAA -> GGTGGCCGGTGTTAGCAAT
CCCAGTTGCCATTAGGCGC -> CCAGTTGCCATTAGGCGCC
AGTTCTGTGTCCCGGTAGT -> GTTCTGTGTCCCGGTAGTG
TAGTGTTGGTGGACCAATC -> AGTGTTGGTGGACCAATCA
GCTTCCAGCCAGGGGTTGC -> CTTCCAGCCAGGGGTTGCT
ATGGTGAATCTAGTCCGCC -> TGGTGAATCTAGTCCGCCT
AAATTCTCAGATTTAGTTC -> AATTCTCAGATTTAGTTCG
AAGAGATTCATCACACACC -> AGAGATTCATCACACACCA
ATGCTGCCGGCCCTCAACG -> TGCTGCCGGCCCTCAACGT
CTAGGGCTGAAATGTAGAC -> TAGGGCTGAAATGTAGACG
TTGGTCCCCCCGAGTTATA -> TGGTCCCCCCGAGTTATAC
TCTCTTCTGCTCCAAATTG -> CTCTTCTGCTCCAAATTGC
GTGCGGTGATCTGGGGGCA -> TGCGGTGATCTGGGGGCAG
TTACAGCGCCATGACGGTA -> TACAGCGCCATGACGGTAG
ATTTGCAAGCTCGGAAGCC -> TTTGCAAGCTCGGAAGCCT
TGTGGGCTGTTTGCTCCGG -> GTGGGCTGTTTGCTCCGGA
GTACAATATCATGGTGAAT -> TACAATATCATGGTGAATC
ACGTTGGGCTATCTTATAA -> CGTTGGGCTATCTTATAAC
CATCACCGGAGTTCTGTGT -> ATCACCGGAGTTCTGTGTC
ATCTATCCACACTTTCGAT -> TCTATCCACACTTTCGATG
AAATCCCGCAGGATCGCTT -> AATCCCGCAGGATCGCTTC
TGTAGACGAAACTATTAAC -> GTAGACGAAACTATTAACC
CGGTCCACAAGGGCAACAA -> GGTCCACAAGGGCAACAAA
TCCCGGTAGTGATTCTACT -> CCCGGTAGTGATTCTACTT
TTCTGTGTCCCGGTAGTGA -> TCTGTGTCCCGGTAGTGAT
TGACAGAGCCCGTTTTACC -> GACAGAGCCCGTTTTACCC
ACGTTAGCAATCGCTGAAT -> CGTTAGCAATCGCTGAATC
GCAGCCATGAATGACTACT -> CAGCCATGAATGACTACTC
TTGGCACAGCGGGGGCGCT -> TGGCACAGCGGGGGCGCTC
GTCACCGAGCACCCCAAAC -> TCACCGAGCACCCCAAACT
TTCCCTATTCCGCATCGAT -> TCCCTATTCCGCATCGATT
ATTTGTTTCGGTGGAAAGA -> TTTGTTTCGGTGGAAAGAC
CTTGTATAAGGTCACTGCT -> TTGTATAAGGTCACTGCTT
CGGGGCGGATGAAAGAGAT -> GGGGCGGATGAAAGAGATT
TACGCCGCCGGTAAACTAG -> ACGCCGCCGGTAAACTAGT
ACAAGGGCAACAAATATCC -> CAAGGGCAACAAATATCCG
GGCGCCGTGGATCTAGTCA -> GCGCCGTGGATCTAGTCAA
AAGGATGTAGCAACAGTTG -> AGGATGTAGCAACAGTTGG
CCCGGTAGTGATTCTACTT -> CCGGTAGTGATTCTACTTT
CAGGTGTACGTAAGTCCAA -> AGGTGTACGTAAGTCCAAC
TCCCGTATTGTCCGATAGA -> CCCGTATTGTCCGATAGAC
CTTCCAGCCAGGGGTTGCT -> TTCCAGCCAGGGGTTGCTC
CTCGGCTCTGATGTGGGCT -> TCGGCTCTGATGTGGGCTG
GCAGTTCTTTAACTAAAAT -> CAGTTCTTTAACTAAAATC
CTTTGTGTAGCAACAGTTG -> TTTGTGTAGCAACAGTTGG
CTTCCGGACCACCTTCAAC -> TTCCGGACCACCTTCAACT
TCGATTTTTCTCACCTTGT -> CGATTTTTCTCACCTTGTC
TTGGCCAATAATTTTTGCC -> TGGCCAATAATTTTTGCCG
TCGCGATGCCTTGAAGAAG -> CGCGATGCCTTGAAGAAGG
ATGTGCGGTGATCTGGGGG -> TGTGCGGTGATCTGGGGGC
TAAGGTTCCATACTAACCT -> AAGGTTCCATACTAACCTT
TCGCTAGAGACCTTTCGCT -> CGCTAGAGACCTTTCGCTA
AGAAATTTGCAAGCTCGGA -> GAAATTTGCAAGCTCGGAA
TCACGTGATCTTCGGTGAC -> CACGTGATCTTCGGTGACA
TCTCTTGAGGGGTTCTCTG -> CTCTTGAGGGGTTCTCTGG
CATCGCCGCAGTTCTTTAA -> ATCGCCGCAGTTCTTTAAC
TATCGAGCACTCTAACACA -> ATCGAGCACTCTAACACAC
TATACAACTTTGGGTGCGT -> ATACAACTTTGGGTGCGTA
GCGCTCTTCTGCTCCAAAT -> CGCTCTTCTGCTCCAAATT
GCCGGTGTTAGCAATTCCG -> CCGGTGTTAGCAATTCCGT
CTGGTGTTCGAATCGGATT -> TGGTGTTCGAATCGGATTT
TGACTGTTAGAGCCGCTTT -> GACTGTTAGAGCCGCTTTG
TTGGTGTCGTGGCGGTATA -> TGGTGTCGTGGCGGTATAT
TTCTGCTCCAAATTGCTTC -> TCTGCTCCAAATTGCTTCC
CGCTGCTGACGGTGGCCGG -> GCTGCTGACGGTGGCCGGT
CGATGCCTTGAAGAAGGTG -> GATGCCTTGAAGAAGGTGT
CGCCTTGTCTGGGCTCATC -> GCCTTGTCTGGGCTCATCA
GCTCCGGGTACGTTGGGCT -> CTCCGGGTACGTTGGGCTA
GTTATTAGTTCTTCTGCTC -> TTATTAGTTCTTCTGCTCC
TAGCAATTCCGTATGTATA -> AGCAATTCCGTATGTATAT
TGGGGTTACAGCTAAGGGT -> GGGGTTACAGCTAAGGGTG
GTCTTACAGCGCCATGACG -> TCTTACAGCGCCATGACGG
GTACTGCCGATATCCTTGT -> TACTGCCGATATCCTTGTA
CTTATAACAAGCGGAGCAA -> TTATAACAAGCGGAGCAAA
ACGCTCATATGAAAAGCGT -> CGCTCATATGAAAAGCGTG
AGACGCCGGAACGGGTGCA -> GACGCCGGAACGGGTGCAC
ATTTACCCGCATCTAGTGA -> TTTACCCGCATCTAGTGAT
ATCGCCGCAGTTCTTTAAC -> TCGCCGCAGTTCTTTAACT
CAGTAGTATGCTGCCGGCC -> AGTAGTATGCTGCCGGCCC
TAGAGCCGCTTTGTGTAGC -> AGAGCCGCTTTGTGTAGCA
CCAAATTGCTTAGTGCGGG -> CAAATTGCTTAGTGCGGGC
GCCTTTTAAGGATGTAGCA -> CCTTTTAAGGATGTAGCAA
CACCAACTAGACTGCTCCG -> ACCAACTAGACTGCTCCGG
GGTGATCTGGGGGCAGCCA -> GTGATCTGGGGGCAGCCAT
GTCCCGGTAGTGATTCTAC -> TCCCGGTAGTGATTCTACT
TCGTAAAGCCACCAACTAG -> CGTAAAGCCACCAACTAGA
TGTCCCAAATCCCGCAGGA -> GTCCCAAATCCCGCAGGAT
ACCGGAGTTCTGTGTCCCG -> CCGGAGTTCTGTGTCCCGG
ACGCCGCCGGTAAACTAGT -> CGCCGCCGGTAAACTAGTC
TCGTGGCGGTATATACAAC -> CGTGGCGGTATATACAACT
ATCCCGCAGGATCGCTTCC -> TCCCGCAGGATCGCTTCCA
ACGGTGGCCGGTGTTAGCA -> CGGTGGCCGGTGTTAGCAA
CCTTGAGTGGAGGTAGTGT -> CTTGAGTGGAGGTAGTGTT
GCCATGAATGACTACTCGG -> CCATGAATGACTACTCGGC
GGAGAACAACTCGGAACAG -> GAGAACAACTCGGAACAGA
GTAGTGATTCTACTTTGCG -> TAGTGATTCTACTTTGCGG
GGCGGTTGGTGTCGTGGCG -> GCGGTTGGTGTCGTGGCGG
GGCAGCCATGAATGACTAC -> GCAGCCATGAATGACTACT
TCAGACCTAGAGCTATGGG -> CAGACCTAGAGCTATGGGG
CCTGATCGCACAGGAGAAC -> CTGATCGCACAGGAGAACA
CATTCCCTATTCCGCATCG -> ATTCCCTATTCCGCATCGA
TGTATACAATCGTCCAACA -> GTATACAATCGTCCAACAA
TGCCGGTACGCTTTCTGTA -> GCCGGTACGCTTTCTGTAG
ATCACCGGAGTTCTGTGTC -> TCACCGGAGTTCTGTGTCC
ACTTTGCGGTCCACAAGGG -> CTTTGCGGTCCACAAGGGC
TGCCTTGAAGAAGGTGTCT -> GCCTTGAAGAAGGTGTCTC
GTGTCGCGATGCCTTGAAG -> TGTCGCGATGCCTTGAAGA
TTCCGTATGTATATATTAG -> TCCGTATGTATATATTAGA
TGTTTCTCGGTAACCGTCA -> GTTTCTCGGTAACCGTCAC
CCGGCCCTCAACGTGCGAG -> CGGCCCTCAACGTGCGAGT
CAAATTGCTTAAGTCACAC -> AAATTGCTTAAGTCACACC
AGCCTCGGTTCATTCCCTA -> GCCTCGGTTCATTCCCTAT
GGTCCAGAAACGTTAGCAA -> GTCCAGAAACGTTAGCAAT
GGCTCTGATGTGGGCTGTT -> GCTCTGATGTGGGCTGTTT
GTAGGGTACTATCGAGCAC -> TAGGGTACTATCGAGCACT
CTAACTTTCGGACGGCGCC -> TAACTTTCGGACGGCGCCG
CCCTCTTCCCGTATTGTCC -> CCTCTTCCCGTATTGTCCG
TCTGCTGTTTCTCGGTAAC -> CTGCTGTTTCTCGGTAACC
GGTTCATCGATACTGAAAA -> GTTCATCGATACTGAAAAG
TGTTTCTGCTGTTTCTCGG -> GTTTCTGCTGTTTCTCGGT
GGGAGCTGAGGGCTGGGCC -> GGAGCTGAGGGCTGGGCCT
GGGCGGAGCGCAAGGTCTC -> GGCGGAGCGCAAGGTCTCC
TTAGGCATTCGATTTTTCT -> TAGGCATTCGATTTTTCTC
TCTGTAGCAACAGTTGGCA -> CTGTAGCAACAGTTGGCAC
CGTGGTCTTCTGCTCCAAA -> GTGGTCTTCTGCTCCAAAT
ACTCATCGCTGGTGTTCGA -> CTCATCGCTGGTGTTCGAA
TTGAGGGGTTCTCTGGGTT -> TGAGGGGTTCTCTGGGTTC
CAACCTCGAGTGGCCAGGT -> AACCTCGAGTGGCCAGGTG
AGCCTTCCCCGTCCCAGGC -> GCCTTCCCCGTCCCAGGCA
GCCATTAGGCGCCAAAGGC -> CCATTAGGCGCCAAAGGCC
CCAGCAACCGGGGCGGATG -> CAGCAACCGGGGCGGATGA
CCGATAGACGCTCATATGA -> CGATAGACGCTCATATGAA
ACAGTTCTGACTAAGCCTT -> CAGTTCTGACTAAGCCTTC
TCTGACAGAGCCCGTTTTA -> CTGACAGAGCCCGTTTTAC
TGCTCCGGGTACGTTGGGC -> GCTCCGGGTACGTTGGGCT
GTAACAAATTCTCAGATTT -> TAACAAATTCTCAGATTTA
GTCCTTAGGAGTTGGAGGG -> TCCTTAGGAGTTGGAGGGT
TGGGTCGTTAAGCCCCCAT -> GGGTCGTTAAGCCCCCATT
TGGCGGTATATACAACTTT -> GGCGGTATATACAACTTTG
TCTATCCACACTTTCGATG -> CTATCCACACTTTCGATGT
CACCTTTAATAATCTCTTC -> ACCTTTAATAATCTCTTCT
TCTTATAACAAGCGGAGCA -> CTTATAACAAGCGGAGCAA
CCAAATTGCTTCCAGCCAG -> CAAATTGCTTCCAGCCAGG
TCGAAACTCGCCTTATAAA -> CGAAACTCGCCTTATAAAA
AGCAGGCTGATGATCCGCC -> GCAGGCTGATGATCCGCCA
CTCTTCCGGACCACCTTCA -> TCTTCCGGACCACCTTCAA
CTCCAAATTGCTTAAGTCA -> TCCAAATTGCTTAAGTCAC
TACCCGCATCTAGTGATGC -> ACCCGCATCTAGTGATGCC
CGTATGTATATATTAGAAG -> GTATGTATATATTAGAAGA
CACCCCAAACTTCATGTCA -> ACCCCAAACTTCATGTCAT
CTTACAGCGCCATGACGGT -> TTACAGCGCCATGACGGTA
CTAGAGACCTTTCGCTACC -> TAGAGACCTTTCGCTACCT
CCGCCTTGTCTGGGCTCAT -> CGCCTTGTCTGGGCTCATC
GAGGGGTTCTCTGGGTTCA -> AGGGGTTCTCTGGGTTCAT
GCATCTAGTGATGCCGGTA -> CATCTAGTGATGCCGGTAC
CCTCGGTTCATTCCCTATT -> CTCGGTTCATTCCCTATTC
TCTGACATCAATAACATTT -> CTGACATCAATAACATTTA
TCTCGGTAACCGTCACCGA -> CTCGGTAACCGTCACCGAG
GCTGACTGTTAGAGCCGCT -> CTGACTGTTAGAGCCGCTT
TGTGGCTACTCATCGCTGG -> GTGGCTACTCATCGCTGGT
ACGAAGATCGCGTAACAAA -> CGAAGATCGCGTAACAAAT
TTAGGCGCCAAAGGCCCCA -> TAGGCGCCAAAGGCCCCAC
GGCTCATCATTAGGCATTC -> GCTCATCATTAGGCATTCG
GCAGAAATTTGCAAGCTCG -> CAGAAATTTGCAAGCTCGG
TCCATACTAACCTTGGCCA -> CCATACTAACCTTGGCCAA
AAATTGCTTAAGTCACACC -> AATTGCTTAAGTCACACCG
AACCTTGAGTGGAGGTAGT -> ACCTTGAGTGGAGGTAGTG
TTTGGTCCCCCCGAGTTAT -> TTGGTCCCCCCGAGTTATA
TTTCGATGTGGCTACTCAT -> TTCGATGTGGCTACTCATC
CAAACGCCGTGATTCTGAC -> AAACGCCGTGATTCTGACA
GGTGTCGTGGCGGTATATA -> GTGTCGTGGCGGTATATAC
TGGCACGAGTTATTAGTTC -> GGCACGAGTTATTAGTTCT
ACGAGTTATTAGTTCTTCT -> CGAGTTATTAGTTCTTCTG
AGGTCACTGCTTCGATAAG -> GGTCACTGCTTCGATAAGG
TCACGGTAGGGTACTATCG -> CACGGTAGGGTACTATCGA
CGGTGTTAGCAATTCCGTA -> GGTGTTAGCAATTCCGTAT
CCGCCAACCTCGAGTGGCC -> CGCCAACCTCGAGTGGCCA
AGCTGAGGGCTGGGCCTTT -> GCTGAGGGCTGGGCCTTTT
AATTGCTTAAGTCACACCG -> ATTGCTTAAGTCACACCGG
GGACCAATCACGTGATCTT -> GACCAATCACGTGATCTTC
CATCGATTGGGTCGTTAAG -> ATCGATTGGGTCGTTAAGC
GGCCCCACTCTTCCGGACC -> GCCCCACTCTTCCGGACCA
GAAGCCTCGGTTCATTCCC -> AAGCCTCGGTTCATTCCCT
TTGCTTAAGTCACACCGGG -> TGCTTAAGTCACACCGGGC
CTGACTGTTAGAGCCGCTT -> TGACTGTTAGAGCCGCTTT
ATAAGGTTCCATACTAACC -> TAAGGTTCCATACTAACCT
CGAAGATCGCGTAACAAAT -> GAAGATCGCGTAACAAATT
ACGGTAGGGTACTATCGAG -> CGGTAGGGTACTATCGAGC
CTAGTCTCGTTTTGGTCCC -> TAGTCTCGTTTTGGTCCCC
TTCGCGAACATCTCGCCTT -> TCGCGAACATCTCGCCTTT
TGGGCTGTTTGCTCCGGAG -> GGGCTGTTTGCTCCGGAGT
TAACATTTACCCGCATCTA -> AACATTTACCCGCATCTAG
GGACCACCTTCAACTTCTG -> GACCACCTTCAACTTCTGG
TGTAGCAACAGTTGGCACC -> GTAGCAACAGTTGGCACCT
CTACTCATCGCTGGTGTTC -> TACTCATCGCTGGTGTTCG
CTCTGACAGAGCCCGTTTT -> TCTGACAGAGCCCGTTTTA
CCGGAGTGGGCAAGTGTCG -> CGGAGTGGGCAAGTGTCGC
AGTGCGGGCGGCCAGCAAC -> GTGCGGGCGGCCAGCAACC
TCACGAGCGGAGACGATCG -> CACGAGCGGAGACGATCGG
TAAAAAATCAGACCTAGAG -> AAAAAATCAGACCTAGAGC
CCCCGTCCCAGGCAACCTG -> CCCGTCCCAGGCAACCTGG
CTGGGTTCATCGATACTGA -> TGGGTTCATCGATACTGAA
CGGGGGCGCTCTTCTGCTC -> GGGGGCGCTCTTCTGCTCC
AACGGGTGCACTCGCTAGA -> ACGGGTGCACTCGCTAGAG
GGTCCACAAGGGCAACAAA -> GTCCACAAGGGCAACAAAT
GTGTTAGCAATTCCGTATG -> TGTTAGCAATTCCGTATGT
TGACGGTAGAGGACGATCT -> GACGGTAGAGGACGATCTG
TGTCGTGGCGGTATATACA -> GTCGTGGCGGTATATACAA
GTGGCTACTCATCGCTGGT -> TGGCTACTCATCGCTGGTG
CGGTCCAGAAACGTTAGCA -> GGTCCAGAAACGTTAGCAA
TCCACACTTTCGATGTGGC -> CCACACTTTCGATGTGGCT
CATACTAACCTTGGCCAAT -> ATACTAACCTTGGCCAATA
CAATAATTTTTGCCGATGT -> AATAATTTTTGCCGATGTG
CAACAACATCACCGGAGTT -> AACAACATCACCGGAGTTC
GGTCTCCGTCATATGACAA -> GTCTCCGTCATATGACAAT
CTCCAAATTGCTGACTGTT -> TCCAAATTGCTGACTGTTA
AACTATTAACCCGGTCCAG -> ACTATTAACCCGGTCCAGA
TTAACCCGGTCCAGAAACG -> TAACCCGGTCCAGAAACGT
TAAACCTTGAGTGGAGGTA -> AAACCTTGAGTGGAGGTAG
GCAAAGCAGAAATTTGCAA -> CAAAGCAGAAATTTGCAAG
GGGTGGCGCTCACTGCCGA -> GGTGGCGCTCACTGCCGAT
TTCTCTGGGTTCATCGATA -> TCTCTGGGTTCATCGATAC
TAAACTAGTCTCGTTTTGG -> AAACTAGTCTCGTTTTGGT
GGTTGGTCATCGCCGCAGT -> GTTGGTCATCGCCGCAGTT
ATCGGATTTTAAACCTTGA -> TCGGATTTTAAACCTTGAG
GCCTTGTCTGGGCTCATCA -> CCTTGTCTGGGCTCATCAT
TATTAGTTCTTCTGCTCCA -> ATTAGTTCTTCTGCTCCAA
CGGACCACCTTCAACTTCT -> GGACCACCTTCAACTTCTG
TCTGGGGGCAGCCATGAAT -> CTGGGGGCAGCCATGAATG
CCAAAGGCCCCACTCTTCC -> CAAAGGCCCCACTCTTCCG
AGGGCAACAAATATCCGCT -> GGGCAACAAATATCCGCTG
CAACCTGGCGGTTGGTGTC -> AACCTGGCGGTTGGTGTCG
GGACGGCGCCGTGGATCTA -> GACGGCGCCGTGGATCTAG
GGTGAATCTAGTCCGCCTT -> GTGAATCTAGTCCGCCTTG
AACATCACCGGAGTTCTGT -> ACATCACCGGAGTTCTGTG
TTTCGGTGGAAAGACTCAG -> TTCGGTGGAAAGACTCAGT
GGTGTTCCCATTTGATTTT -> GTGTTCCCATTTGATTTTG
CTCGTTTTGGTCCCCCCGA -> TCGTTTTGGTCCCCCCGAG
GGTTCCATACTAACCTTGG -> GTTCCATACTAACCTTGGC
AAACCCTCTTCCCGTATTG -> AACCCTCTTCCCGTATTGT
TGGTCTTCTGCTCCAAATT -> GGTCTTCTGCTCCAAATTG
TCGCTTCCACTCTGACAGA -> CGCTTCCACTCTGACAGAG
GATGTGGGTCCTTAGGAGT -> ATGTGGGTCCTTAGGAGTT
CAGCTAAGGGTGTTCCCAT -> AGCTAAGGGTGTTCCCATT
CCATGAATGACTACTCGGC -> CATGAATGACTACTCGGCC
GAGACCTTTCGCTACCTCG -> AGACCTTTCGCTACCTCGC
CAACTTTGGGTGCGTACAA -> AACTTTGGGTGCGTACAAT
CGGTAGTGATTCTACTTTG -> GGTAGTGATTCTACTTTGC
ATTGGTTGGTCATCGCCGC -> TTGGTTGGTCATCGCCGCA
ATCCGTACTGCCGATATCC -> TCCGTACTGCCGATATCCT
AATGACTACTCGGCCATAC -> ATGACTACTCGGCCATACG
GACTAAGCCTTCCCCGTCC -> ACTAAGCCTTCCCCGTCCC
GTTAGAGCCGCTTTGTGTA -> TTAGAGCCGCTTTGTGTAG
CGTGATTCTGACATCAATA -> GTGATTCTGACATCAATAA
GTTCATTCCCTATTCCGCA -> TTCATTCCCTATTCCGCAT
TCTCCGTCATATGACAATA -> CTCCGTCATATGACAATAT
TATGGGGTTACAGCTAAGG -> ATGGGGTTACAGCTAAGGG
AACAAATTCTCAGATTTAG -> ACAAATTCTCAGATTTAGT
GATGCCTTGAAGAAGGTGT -> ATGCCTTGAAGAAGGTGTC
TCTGCTCCAAATTGCTTAA -> CTGCTCCAAATTGCTTAAG
GGTACTATCGAGCACTCTA -> GTACTATCGAGCACTCTAA
CTTCTGGGGAACAGTAGAT -> TTCTGGGGAACAGTAGATA
TGTGTAGCAACAGTTGGCA -> GTGTAGCAACAGTTGGCAC
GCGGAGACGATCGGAGTAA -> CGGAGACGATCGGAGTAAC
ACCTTCAACTTCTGGGGAA -> CCTTCAACTTCTGGGGAAC
GTGGCCGGTGTTAGCAATT -> TGGCCGGTGTTAGCAATTC
AGCCGCTTTGTGTAGCAAC -> GCCGCTTTGTGTAGCAACA
ATCTAGTGATGCCGGTACG -> TCTAGTGATGCCGGTACGC
TGCTTCCAGCCAGGGGTTG -> GCTTCCAGCCAGGGGTTGC
ACTCTGACAGAGCCCGTTT -> CTCTGACAGAGCCCGTTTT
TCGTCCAACAACATCACCG -> CGTCCAACAACATCACCGG
AACTTTCGGACGGCGCCGT -> ACTTTCGGACGGCGCCGTG
TAGCAACTGGACATCAACT -> AGCAACTGGACATCAACTA
ATAAGGTCACTGCTTCGAT -> TAAGGTCACTGCTTCGATA
GAAGAAGGTGTCTCGGAGC -> AAGAAGGTGTCTCGGAGCT
ACTCGGCCATACGTTAGCA -> CTCGGCCATACGTTAGCAA
GTCCGCCTTGTCTGGGCTC -> TCCGCCTTGTCTGGGCTCA
GTTGGCACCTTTAATAATC -> TTGGCACCTTTAATAATCT
ACCGCAACAAACGCCGTGA -> CCGCAACAAACGCCGTGAT
CCAAATCCCGCAGGATCGC -> CAAATCCCGCAGGATCGCT
AATAATCTCTTCTGCTCCA -> ATAATCTCTTCTGCTCCAA
GGATGAAAGAGATTCATCA -> GATGAAAGAGATTCATCAC
ACAACTCGGAACAGACGCC -> CAACTCGGAACAGACGCCG
TTGGCACCCAGTTGCCATT -> TGGCACCCAGTTGCCATTA
AAGGTGTCTCGGAGCTAAC -> AGGTGTCTCGGAGCTAACT
CTTGGCACCCAGTTGCCAT -> TTGGCACCCAGTTGCCATT
CTGCTCCAAATTGCTTAAG -> TGCTCCAAATTGCTTAAGT
ACTTCATGTCATTACATTG -> CTTCATGTCATTACATTGG
ATCTTATAACAAGCGGAGC -> TCTTATAACAAGCGGAGCA
CCTCGCGCGTCGGGTAACT -> CTCGCGCGTCGGGTAACTA
CTGCCGGCCCTCAACGTGC -> TGCCGGCCCTCAACGTGCG
TTGCCGATGTGCGGTGATC -> TGCCGATGTGCGGTGATCT
GGCCAGCAACCGGGGCGGA -> GCCAGCAACCGGGGCGGAT
GCCAAAGGCCCCACTCTTC -> CCAAAGGCCCCACTCTTCC
CGGGTGCACTCGCTAGAGA -> GGGTGCACTCGCTAGAGAC
CAGTTGGCACGAGTTATTA -> AGTTGGCACGAGTTATTAG
AGTAGTATGCTGCCGGCCC -> GTAGTATGCTGCCGGCCCT
CAGGAGAACAACTCGGAAC -> AGGAGAACAACTCGGAACA
TCGTATTGGTTGGTCATCG -> CGTATTGGTTGGTCATCGC
CAGACGCCGGAACGGGTGC -> AGACGCCGGAACGGGTGCA
GTTACAGCTAAGGGTGTTC -> TTACAGCTAAGGGTGTTCC
TCGCGATCACGAGCGGAGA -> CGCGATCACGAGCGGAGAC
ACACACCGCAACAAACGCC -> CACACCGCAACAAACGCCG
CATTACATTGGACGTGTTG -> ATTACATTGGACGTGTTGG
GCTGAATCAGTATTGTAGT -> CTGAATCAGTATTGTAGTA
GATGATCCGCCAACCTCGA -> ATGATCCGCCAACCTCGAG
AAATTGCTGACTGTTAGAG -> AATTGCTGACTGTTAGAGC
GTTGGTGGACCAATCACGT -> TTGGTGGACCAATCACGTG
ACTATCCGTACTGCCGATA -> CTATCCGTACTGCCGATAT
TCAACTTCTGGGGAACAGT -> CAACTTCTGGGGAACAGTA
AACATCTCGCCTTTGATGT -> ACATCTCGCCTTTGATGTC
TAACCGTCACCGAGCACCC -> AACCGTCACCGAGCACCCC
GTGGGCAAGTGTCGCGATG -> TGGGCAAGTGTCGCGATGC
TAAGCCTTCCCCGTCCCAG -> AAGCCTTCCCCGTCCCAGG
GCACCTTTAATAATCTCTT -> CACCTTTAATAATCTCTTC
GTATTGGTTGGTCATCGCC -> TATTGGTTGGTCATCGCCG
TCCCAGGCAACCTGGCGGT -> CCCAGGCAACCTGGCGGTT
GCACTCTAACACACACCGC -> CACTCTAACACACACCGCA
AGATTTAGTTCGCGAACAT -> GATTTAGTTCGCGAACATC
GAGTGGGCAAGTGTCGCGA -> AGTGGGCAAGTGTCGCGAT
CGCGCGTCGGGTAACTATC -> GCGCGTCGGGTAACTATCC
ATCGCACAGGAGAACAACT -> TCGCACAGGAGAACAACTC
AACCTTGGCCAATAATTTT -> ACCTTGGCCAATAATTTTT
AAGCTCGGAAGCCTCGGTT -> AGCTCGGAAGCCTCGGTTC
AAACCTTGAGTGGAGGTAG -> AACCTTGAGTGGAGGTAGT
TCATGTCATTACATTGGAC -> CATGTCATTACATTGGACG
GCCGATGTGCGGTGATCTG -> CCGATGTGCGGTGATCTGG
TCGTTTTGGTCCCCCCGAG -> CGTTTTGGTCCCCCCGAGT
CCGTATGTATATATTAGAA -> CGTATGTATATATTAGAAG
AGCGTGTGTATACAATCGT -> GCGTGTGTATACAATCGTC
TCTAGTCAAATCTATCCAC -> CTAGTCAAATCTATCCACA
AAAGAGATTCATCACACAC -> AAGAGATTCATCACACACC
CTAACACACACCGCAACAA -> TAACACACACCGCAACAAA
TCCCAAATCCCGCAGGATC -> CCCAAATCCCGCAGGATCG
GGAGACGATCGGAGTAACG -> GAGACGATCGGAGTAACGA
CTAACCTTGGCCAATAATT -> TAACCTTGGCCAATAATTT
ATCAGTATTGTAGTAGAGG -> TCAGTATTGTAGTAGAGGG
GTTGGCGATTGACCGCTAA -> TTGGCGATTGACCGCTAAC
GGAGTTCTGTGTCCCGGTA -> GAGTTCTGTGTCCCGGTAG
CGCTAACTTTCGGACGGCG -> GCTAACTTTCGGACGGCGC
ACATTGGACGTGTTGGCGA -> CATTGGACGTGTTGGCGAT
GCCTTGAAGAAGGTGTCTC -> CCTTGAAGAAGGTGTCTCG
GCTTTCTGTAGCAACAGTT -> CTTTCTGTAGCAACAGTTG
CTTCGTATTGGTTGGTCAT -> TTCGTATTGGTTGGTCATC
ATGATCACGGTAGGGTACT -> TGATCACGGTAGGGTACTA
CTTGTCACCACGGACCTGA -> TTGTCACCACGGACCTGAT
ACCAACTAGACTGCTCCGG -> CCAACTAGACTGCTCCGGG
GCACGAGTTATTAGTTCTT -> CACGAGTTATTAGTTCTTC
GCAAGGTCTCCGTCATATG -> CAAGGTCTCCGTCATATGA
CTGACTAAGCCTTCCCCGT -> TGACTAAGCCTTCCCCGTC
TAGTCAAATCTATCCACAC -> AGTCAAATCTATCCACACT
TCTGCTGGCTTGGCACCCA -> CTGCTGGCTTGGCACCCAG
ACCGGGCGGAGCGCAAGGT -> CCGGGCGGAGCGCAAGGTC
GACTACTCGGCCATACGTT -> ACTACTCGGCCATACGTTA
TCTGGGTTCATCGATACTG -> CTGGGTTCATCGATACTGA
ACAGGAGAACAACTCGGAA -> CAGGAGAACAACTCGGAAC
CGCTACCTCGCGCGTCGGG -> GCTACCTCGCGCGTCGGGT
AACACACACCGCAACAAAC -> ACACACACCGCAACAAACG
GGTGTTAGCAATTCCGTAT -> GTGTTAGCAATTCCGTATG
TGGGTGCGTACAATATCAT -> GGGTGCGTACAATATCATG
GATGTGGCTACTCATCGCT -> ATGTGGCTACTCATCGCTG
TACAATATCATGGTGAATC -> ACAATATCATGGTGAATCT
CCACTCTTCCGGACCACCT -> CACTCTTCCGGACCACCTT
TCCGCCTTGTCTGGGCTCA -> CCGCCTTGTCTGGGCTCAT
TCTTCGGTGACAGTTCTGA -> CTTCGGTGACAGTTCTGAC
AAGCCCCCATTACGATCTG -> AGCCCCCATTACGATCTGC
GGCACCTTTAATAATCTCT -> GCACCTTTAATAATCTCTT
GAATCTAGTCCGCCTTGTC -> AATCTAGTCCGCCTTGTCT
GGGTGCACTCGCTAGAGAC -> GGTGCACTCGCTAGAGACC
GTGTCGTGGCGGTATATAC -> TGTCGTGGCGGTATATACA
AAGGCCTCTAGGGCTGAAA -> AGGCCTCTAGGGCTGAAAT
TTTAAGGATGTAGCAACAG -> TTAAGGATGTAGCAACAGT
CAACAGTTGGCACAGCGGG -> AACAGTTGGCACAGCGGGG
GATATCCTTGTAGCAACAG -> ATATCCTTGTAGCAACAGT
ATCGTAAAGCCACCAACTA -> TCGTAAAGCCACCAACTAG
ATGTATATATTAGAAGAGG -> TGTATATATTAGAAGAGGG
ATCCGCTGCTGACGGTGGC -> TCCGCTGCTGACGGTGGCC
GTAAAGCCACCAACTAGAC -> TAAAGCCACCAACTAGACT
CCCACTTGATCGTAAAGCC -> CCACTTGATCGTAAAGCCA
CAACTGGACATCAACTACG -> AACTGGACATCAACTACGC
TTGGCACGAGTTATTAGTT -> TGGCACGAGTTATTAGTTC
ATTTAGTTCGCGAACATCT -> TTTAGTTCGCGAACATCTC
GTTGGAGGGTGGCGCTCAC -> TTGGAGGGTGGCGCTCACT
CCGCAGGATCGCTTCCACT -> CGCAGGATCGCTTCCACTC
TGGATCTAGTCAAATCTAT -> GGATCTAGTCAAATCTATC
ATATGAAAAGCGTGTGTAT -> TATGAAAAGCGTGTGTATA
TTATAAAACCCTCTTCCCG -> TATAAAACCCTCTTCCCGT
GGTAGTGATTCTACTTTGC -> GTAGTGATTCTACTTTGCG
CGTCACCGAGCACCCCAAA -> GTCACCGAGCACCCCAAAC
GATGAAAGAGATTCATCAC -> ATGAAAGAGATTCATCACA
CTCGGAGCTAACTGATCTC -> TCGGAGCTAACTGATCTCT
ATTCTACTTTGCGGTCCAC -> TTCTACTTTGCGGTCCACA
CAACCGGGGCGGATGAAAG -> AACCGGGGCGGATGAAAGA
TGCCATTAGGCGCCAAAGG -> GCCATTAGGCGCCAAAGGC
GCAATCGCTGAATCAGTAT -> CAATCGCTGAATCAGTATT
TTTAAACCTTGAGTGGAGG -> TTAAACCTTGAGTGGAGGT
TCATCGCTGGTGTTCGAAT -> CATCGCTGGTGTTCGAATC
GTGTATACAATCGTCCAAC -> TGTATACAATCGTCCAACA
GTCTCCGTCATATGACAAT -> TCTCCGTCATATGACAATA
TTACGATCTGCTGGCTTGG -> TACGATCTGCTGGCTTGGC
TCACCGGAGTTCTGTGTCC -> CACCGGAGTTCTGTGTCCC
TTTACCCAACGAGCGCAGC -> TTACCCAACGAGCGCAGCG
AGGCATTCGATTTTTCTCA -> GGCATTCGATTTTTCTCAC
CGAGCGCAGCGGAACATCT -> GAGCGCAGCGGAACATCTT
ATTAACCCGGTCCAGAAAC -> TTAACCCGGTCCAGAAACG
AACTATCCGTACTGCCGAT -> ACTATCCGTACTGCCGATA
TGTCGCGATGCCTTGAAGA -> GTCGCGATGCCTTGAAGAA
GCTGCCGGCCCTCAACGTG -> CTGCCGGCCCTCAACGTGC
CAAGCTCGGAAGCCTCGGT -> AAGCTCGGAAGCCTCGGTT
TTGGGTCGTTAAGCCCCCA -> TGGGTCGTTAAGCCCCCAT
GTGATTCTACTTTGCGGTC -> TGATTCTACTTTGCGGTCC
CTTCATGTCATTACATTGG -> TTCATGTCATTACATTGGA
GCCGATATCCTTGTAGCAA -> CCGATATCCTTGTAGCAAC
CCGGTAAACTAGTCTCGTT -> CGGTAAACTAGTCTCGTTT
TTATTAGTTCTTCTGCTCC -> TATTAGTTCTTCTGCTCCA
CCCGTTTTACCCAACGAGC -> CCGTTTTACCCAACGAGCG
GGTAGTGTTGGTGGACCAA -> GTAGTGTTGGTGGACCAAT
GAGGGAGCTGAGGGCTGGG -> AGGGAGCTGAGGGCTGGGC
CGTTTTGGTCCCCCCGAGT -> GTTTTGGTCCCCCCGAGTT
AGTCTTACAGCGCCATGAC -> GTCTTACAGCGCCATGACG
GTGCGAGTGGGCATAAAAA -> TGCGAGTGGGCATAAAAAA
GGTTCTCTGGGTTCATCGA -> GTTCTCTGGGTTCATCGAT
GGCGGTATATACAACTTTG -> GCGGTATATACAACTTTGG
GAATCGGATTTTAAACCTT -> AATCGGATTTTAAACCTTG
GCTAAGGGTGTTCCCATTT -> CTAAGGGTGTTCCCATTTG
GGGCTATCTTATAACAAGC -> GGCTATCTTATAACAAGCG
CATCGCTGGTGTTCGAATC -> ATCGCTGGTGTTCGAATCG
CGCCTTATAAAACCCTCTT -> GCCTTATAAAACCCTCTTC
GAACAGTAGATAATGATCA -> AACAGTAGATAATGATCAC
CACTTTCGATGTGGCTACT -> ACTTTCGATGTGGCTACTC
CCCGGTCCAGAAACGTTAG -> CCGGTCCAGAAACGTTAGC
CGATCACGAGCGGAGACGA -> GATCACGAGCGGAGACGAT
GCCAATAATTTTTGCCGAT -> CCAATAATTTTTGCCGATG
CATCAATAACATTTACCCG -> ATCAATAACATTTACCCGC
AACTCGCCTTATAAAACCC -> ACTCGCCTTATAAAACCCT
TCATTCCCTATTCCGCATC -> CATTCCCTATTCCGCATCG
AACTTTGGGTGCGTACAAT -> ACTTTGGGTGCGTACAATA
GCGGAACATCTTCGTATTG -> CGGAACATCTTCGTATTGG
TGATTCTGACATCAATAAC -> GATTCTGACATCAATAACA
AGATAATGATCACGGTAGG -> GATAATGATCACGGTAGGG
GAGTAACGAAGATCGCGTA -> AGTAACGAAGATCGCGTAA
AGTTCTGACTAAGCCTTCC -> GTTCTGACTAAGCCTTCCC
ATCTCGCCTTTGATGTCCC -> TCTCGCCTTTGATGTCCCA
GTTCTCTGGGTTCATCGAT -> TTCTCTGGGTTCATCGATA
GGATCTAGTCAAATCTATC -> GATCTAGTCAAATCTATCC
GGTAGGGTACTATCGAGCA -> GTAGGGTACTATCGAGCAC
GAGGTAGTGTTGGTGGACC -> AGGTAGTGTTGGTGGACCA
GGCCAGGTGTACGTAAGTC -> GCCAGGTGTACGTAAGTCC
TCCCATTTGATTTTGTTTC -> CCCATTTGATTTTGTTTCT
ACTAACCTTGGCCAATAAT -> CTAACCTTGGCCAATAATT
GGACGTGTTGGCGATTGAC -> GACGTGTTGGCGATTGACC
CGATAAGGTTCCATACTAA -> GATAAGGTTCCATACTAAC
TCCAGAAACGTTAGCAATC -> CCAGAAACGTTAGCAATCG
TTTAGTTCGCGAACATCTC -> TTAGTTCGCGAACATCTCG
CGAGTTATTAGTTCTTCTG -> GAGTTATTAGTTCTTCTGC
TAATTTTTGCCGATGTGCG -> AATTTTTGCCGATGTGCGG
GTAGCAACAGTTGGCACGA -> TAGCAACAGTTGGCACGAG
ACAAGCGGAGCAAAGCAGA -> CAAGCGGAGCAAAGCAGAA
CCCAACGAGCGCAGCGGAA -> CCAACGAGCGCAGCGGAAC
AGGTTCCATACTAACCTTG -> GGTTCCATACTAACCTTGG
CGAGCACTCTAACACACAC -> GAGCACTCTAACACACACC
TTTAACTAAAATCGAAACT -> TTAACTAAAATCGAAACTC
ATCTCTTCTGCTCCAAATT -> TCTCTTCTGCTCCAAATTG
GTCATATGACAATATTTGT -> TCATATGACAATATTTGTT
GACAGTTCTGACTAAGCCT -> ACAGTTCTGACTAAGCCTT
GCTACCTCGCGCGTCGGGT -> CTACCTCGCGCGTCGGGTA
ACAGCGCCATGACGGTAGA -> CAGCGCCATGACGGTAGAG
GTCCCAGGCAACCTGGCGG -> TCCCAGGCAACCTGGCGGT
TAAGTCACACCGGGCGGAG -> AAGTCACACCGGGCGGAGC
AGGATGTAGCAACAGTTGG -> GGATGTAGCAACAGTTGGC
TTGTAGTAGAGGGAGCTGA -> TGTAGTAGAGGGAGCTGAG
AAAGACTCAGTAGTATGCT -> AAGACTCAGTAGTATGCTG
GGCACCCAGTTGCCATTAG -> GCACCCAGTTGCCATTAGG
TTGGTCATCGCCGCAGTTC -> TGGTCATCGCCGCAGTTCT
CGATCGGAGTAACGAAGAT -> GATCGGAGTAACGAAGATC
CGATATCCTTGTAGCAACA -> GATATCCTTGTAGCAACAG
CCCGTATTGTCCGATAGAC -> CCGTATTGTCCGATAGACG
AACAGTAGATAATGATCAC -> ACAGTAGATAATGATCACG
AAACTCGCCTTATAAAACC -> AACTCGCCTTATAAAACCC
TTCTGACTAAGCCTTCCCC -> TCTGACTAAGCCTTCCCCG
AAACGTTAGCAATCGCTGA -> AACGTTAGCAATCGCTGAA
GCACAGCGGGGGCGCTCTT -> CACAGCGGGGGCGCTCTTC
ACAGCGGGGGCGCTCTTCT -> CAGCGGGGGCGCTCTTCTG
TTGGTTGGTCATCGCCGCA -> TGGTTGGTCATCGCCGCAG
TCATCGATACTGAAAAGGC -> CATCGATACTGAAAAGGCC
CCGGGTACGTTGGGCTATC -> CGGGTACGTTGGGCTATCT
CTTAGTGCGGGCGGCCAGC -> TTAGTGCGGGCGGCCAGCA
AGGGGTTGCTCTTGTATAA -> GGGGTTGCTCTTGTATAAG
TCCCCCCGAGTTATACTCG -> CCCCCCGAGTTATACTCGT
CAACAGTTGGCACTGGATG -> AACAGTTGGCACTGGATGC
GTGTTGGCGATTGACCGCT -> TGTTGGCGATTGACCGCTA
ATGACTACTCGGCCATACG -> TGACTACTCGGCCATACGT
CCATACTAACCTTGGCCAA -> CATACTAACCTTGGCCAAT
TCGGACGGCGCCGTGGATC -> CGGACGGCGCCGTGGATCT
CACTCTTCCGGACCACCTT -> ACTCTTCCGGACCACCTTC
CTGCTTCGATAAGGTTCCA -> TGCTTCGATAAGGTTCCAT
CGCTCACTGCCGATTCGTC -> GCTCACTGCCGATTCGTCG
ATGCCGGTACGCTTTCTGT -> TGCCGGTACGCTTTCTGTA
CTCCGGGTACGTTGGGCTA -> TCCGGGTACGTTGGGCTAT
GCTGTTTCTCGGTAACCGT -> CTGTTTCTCGGTAACCGTC
TTGTAGCAACAGTTGGCAC -> TGTAGCAACAGTTGGCACT
TAATCTCTTCTGCTCCAAA -> AATCTCTTCTGCTCCAAAT
TGTTTCGGTGGAAAGACTC -> GTTTCGGTGGAAAGACTCA
TTGGCACCTTTAATAATCT -> TGGCACCTTTAATAATCTC
CGGAAGCCTCGGTTCATTC -> GGAAGCCTCGGTTCATTCC
GATCTGGGGGCAGCCATGA -> ATCTGGGGGCAGCCATGAA
CGCGTCGGGTAACTATCCG -> GCGTCGGGTAACTATCCGT
AGGCAACCTGGCGGTTGGT -> GGCAACCTGGCGGTTGGTG
TCGCCTTTGATGTCCCAAA -> CGCCTTTGATGTCCCAAAT
CAGGGGTTGCTCTTGTATA -> AGGGGTTGCTCTTGTATAA
CTGGCTTGGCACCCAGTTG -> TGGCTTGGCACCCAGTTGC
TTCAACTTCTGGGGAACAG -> TCAACTTCTGGGGAACAGT
TCATATGAAAAGCGTGTGT -> CATATGAAAAGCGTGTGTA
ATAACATTTACCCGCATCT -> TAACATTTACCCGCATCTA
CTAGTCAAATCTATCCACA -> TAGTCAAATCTATCCACAC
CATTCGATTTTTCTCACCT -> ATTCGATTTTTCTCACCTT
AGCACCCCAAACTTCATGT -> GCACCCCAAACTTCATGTC
TGAGGGCTGGGCCTTTTAA -> GAGGGCTGGGCCTTTTAAG
TATTGTCCGATAGACGCTC -> ATTGTCCGATAGACGCTCA
CTGAAAAGGCCTCTAGGGC -> TGAAAAGGCCTCTAGGGCT
GTGATTCTGACATCAATAA -> TGATTCTGACATCAATAAC
GCAACCTGGCGGTTGGTGT -> CAACCTGGCGGTTGGTGTC
GTCGGGTAACTATCCGTAC -> TCGGGTAACTATCCGTACT
CCATTACGATCTGCTGGCT -> CATTACGATCTGCTGGCTT
GATCGGAGTAACGAAGATC -> ATCGGAGTAACGAAGATCG
TCGGAAGCCTCGGTTCATT -> CGGAAGCCTCGGTTCATTC
GGCGGATGAAAGAGATTCA -> GCGGATGAAAGAGATTCAT
CCGGGGCGGATGAAAGAGA -> CGGGGCGGATGAAAGAGAT
CCCTCAACGTGCGAGTGGG -> CCTCAACGTGCGAGTGGGC
CGGTACGCTTTCTGTAGCA -> GGTACGCTTTCTGTAGCAA
TACTCATCGCTGGTGTTCG -> ACTCATCGCTGGTGTTCGA
CGTTAAGCCCCCATTACGA -> GTTAAGCCCCCATTACGAT
GGAACAGACGCCGGAACGG -> GAACAGACGCCGGAACGGG
GTATTGTAGTAGAGGGAGC -> TATTGTAGTAGAGGGAGCT
CTCCGGAGTGGGCAAGTGT -> TCCGGAGTGGGCAAGTGTC
TCGATTGGGTCGTTAAGCC -> CGATTGGGTCGTTAAGCCC
CGTAAAGCCACCAACTAGA -> GTAAAGCCACCAACTAGAC
CACACACCGCAACAAACGC -> ACACACCGCAACAAACGCC
AGCCCGTTTTACCCAACGA -> GCCCGTTTTACCCAACGAG
GTAGAGGACGATCTGGATG -> TAGAGGACGATCTGGATGT
GAATCAGTATTGTAGTAGA -> AATCAGTATTGTAGTAGAG
GTATGCTGCCGGCCCTCAA -> TATGCTGCCGGCCCTCAAC
ATTGTAGTAGAGGGAGCTG -> TTGTAGTAGAGGGAGCTGA
CTAAGCCTTCCCCGTCCCA -> TAAGCCTTCCCCGTCCCAG
GCATAAAAAATCAGACCTA -> CATAAAAAATCAGACCTAG
ACTCTTCCGGACCACCTTC -> CTCTTCCGGACCACCTTCA
TCGGGTAACTATCCGTACT -> CGGGTAACTATCCGTACTG
GTGGCGGTATATACAACTT -> TGGCGGTATATACAACTTT
ACTTCTGGGGAACAGTAGA -> CTTCTGGGGAACAGTAGAT
CGGTTGGTGTCGTGGCGGT -> GGTTGGTGTCGTGGCGGTA
CCTGGCGGTTGGTGTCGTG -> CTGGCGGTTGGTGTCGTGG
ACAAACGCCGTGATTCTGA -> CAAACGCCGTGATTCTGAC
GAGCAAAGCAGAAATTTGC -> AGCAAAGCAGAAATTTGCA
GACTGTTAGAGCCGCTTTG -> ACTGTTAGAGCCGCTTTGT
GCTAACTTTCGGACGGCGC -> CTAACTTTCGGACGGCGCC
GGATGTAGCAACAGTTGGC -> GATGTAGCAACAGTTGGCA
AATATCCGCTGCTGACGGT -> ATATCCGCTGCTGACGGTG
GTAGTGTTGGTGGACCAAT -> TAGTGTTGGTGGACCAATC
GCACCCCAAACTTCATGTC -> CACCCCAAACTTCATGTCA
AACGAGCGCAGCGGAACAT -> ACGAGCGCAGCGGAACATC
AGAGACCTTTCGCTACCTC -> GAGACCTTTCGCTACCTCG
CAATAACATTTACCCGCAT -> AATAACATTTACCCGCATC
AACCCTCTTCCCGTATTGT -> ACCCTCTTCCCGTATTGTC
GATGCCGGTACGCTTTCTG -> ATGCCGGTACGCTTTCTGT
CGCTTTCTGTAGCAACAGT -> GCTTTCTGTAGCAACAGTT
TAGGGTACTATCGAGCACT -> AGGGTACTATCGAGCACTC
TAGACTGCTCCGGGTACGT -> AGACTGCTCCGGGTACGTT
GTTAGCAATCGCTGAATCA -> TTAGCAATCGCTGAATCAG
ACGTTAGCAACTGGACATC -> CGTTAGCAACTGGACATCA
CGGCCCTCAACGTGCGAGT -> GGCCCTCAACGTGCGAGTG
GAGGACGATCTGGATGTGG -> AGGACGATCTGGATGTGGG
CCCGAGTTATACTCGTTTC -> CCGAGTTATACTCGTTTCC
TAGGGCTGAAATGTAGACG -> AGGGCTGAAATGTAGACGA
ACCCCAAACTTCATGTCAT -> CCCCAAACTTCATGTCATT
GTTCGAATCGGATTTTAAA -> TTCGAATCGGATTTTAAAC
TCTCGTTTTGGTCCCCCCG -> CTCGTTTTGGTCCCCCCGA
CAATCGCTGAATCAGTATT -> AATCGCTGAATCAGTATTG
AGCGGAGACGATCGGAGTA -> GCGGAGACGATCGGAGTAA
CTGGGGAACAGTAGATAAT -> TGGGGAACAGTAGATAATG
AACTGATCTCTTGAGGGGT -> ACTGATCTCTTGAGGGGTT
TCTTGTATAAGGTCACTGC -> CTTGTATAAGGTCACTGCT
GCTCATATGAAAAGCGTGT -> CTCATATGAAAAGCGTGTG
GTGTGTATACAATCGTCCA -> TGTGTATACAATCGTCCAA
TGGGGGCAGCCATGAATGA -> GGGGGCAGCCATGAATGAC
GAACATCTTCGTATTGGTT -> AACATCTTCGTATTGGTTG
AGGATCGCTTCCACTCTGA -> GGATCGCTTCCACTCTGAC
TGGTGTCGTGGCGGTATAT -> GGTGTCGTGGCGGTATATA
CAGTAGATAATGATCACGG -> AGTAGATAATGATCACGGT
TGGGCTATCTTATAACAAG -> GGGCTATCTTATAACAAGC
TTGCTTCCAGCCAGGGGTT -> TGCTTCCAGCCAGGGGTTG
GTGGAGGTAGTGTTGGTGG -> TGGAGGTAGTGTTGGTGGA
CTCGGAAGCCTCGGTTCAT -> TCGGAAGCCTCGGTTCATT
GTAACGAAGATCGCGTAAC -> TAACGAAGATCGCGTAACA
ATCACGAGCGGAGACGATC -> TCACGAGCGGAGACGATCG
CCAACCTCGGCTCTGATGT -> CAACCTCGGCTCTGATGTG
GTAGATAATGATCACGGTA -> TAGATAATGATCACGGTAG
CTTGAGGGGTTCTCTGGGT -> TTGAGGGGTTCTCTGGGTT
AGCAACAGTTGGCACTGGA -> GCAACAGTTGGCACTGGAT
CCCACTCTTCCGGACCACC -> CCACTCTTCCGGACCACCT
CGTAAGTCCAACCTCGGCT -> GTAAGTCCAACCTCGGCTC
GTGGCGCTCACTGCCGATT -> TGGCGCTCACTGCCGATTC
ATTACGATCTGCTGGCTTG -> TTACGATCTGCTGGCTTGG
TGGGGAACAGTAGATAATG -> GGGGAACAGTAGATAATGA
GTTGGTCATCGCCGCAGTT -> TTGGTCATCGCCGCAGTTC
TCTTACAGCGCCATGACGG -> CTTACAGCGCCATGACGGT
CGGAGTTCTGTGTCCCGGT -> GGAGTTCTGTGTCCCGGTA
TTGCTTAGTGCGGGCGGCC -> TGCTTAGTGCGGGCGGCCA
TTCTCACCTTGTCACCACG -> TCTCACCTTGTCACCACGG
CGCTCATATGAAAAGCGTG -> GCTCATATGAAAAGCGTGT
AACAGACGCCGGAACGGGT -> ACAGACGCCGGAACGGGTG
GCCACCAACTAGACTGCTC -> CCACCAACTAGACTGCTCC
GTCATCGCCGCAGTTCTTT -> TCATCGCCGCAGTTCTTTA
TTTTCTCACCTTGTCACCA -> TTTCTCACCTTGTCACCAC
GTCACCACGGACCTGATCG -> TCACCACGGACCTGATCGC
CATTAGGCGCCAAAGGCCC -> ATTAGGCGCCAAAGGCCCC
GGTAACTATCCGTACTGCC -> GTAACTATCCGTACTGCCG
GAAAAGCGTGTGTATACAA -> AAAAGCGTGTGTATACAAT
CTGATGTGGGCTGTTTGCT -> TGATGTGGGCTGTTTGCTC
TGCCGATTCGTCGCGATCA -> GCCGATTCGTCGCGATCAC
CCATGACGGTAGAGGACGA -> CATGACGGTAGAGGACGAT
GTTCCATACTAACCTTGGC -> TTCCATACTAACCTTGGCC
TGGAGGTAGTGTTGGTGGA -> GGAGGTAGTGTTGGTGGAC
CTATTAACCCGGTCCAGAA -> TATTAACCCGGTCCAGAAA
CTAACTGATCTCTTGAGGG -> TAACTGATCTCTTGAGGGG
TTGTCCGATAGACGCTCAT -> TGTCCGATAGACGCTCATA
GTGTTCGAATCGGATTTTA -> TGTTCGAATCGGATTTTAA
TAAGCCCCCATTACGATCT -> AAGCCCCCATTACGATCTG
ATAACAAGCGGAGCAAAGC -> TAACAAGCGGAGCAAAGCA
CGTGATCTTCGGTGACAGT -> GTGATCTTCGGTGACAGTT
GAGCGCAAGGTCTCCGTCA -> AGCGCAAGGTCTCCGTCAT
AGCGCAGCGGAACATCTTC -> GCGCAGCGGAACATCTTCG
CTTCGATAAGGTTCCATAC -> TTCGATAAGGTTCCATACT
GCGGGGGCGCTCTTCTGCT -> CGGGGGCGCTCTTCTGCTC
CTTAAGTCACACCGGGCGG -> TTAAGTCACACCGGGCGGA
CTCAACGTGCGAGTGGGCA -> TCAACGTGCGAGTGGGCAT
ACGATCTGGATGTGGGTCC -> CGATCTGGATGTGGGTCCT
TCCGCATCGATTGGGTCGT -> CCGCATCGATTGGGTCGTT
CTGACAGAGCCCGTTTTAC -> TGACAGAGCCCGTTTTACC
GTTATACTCGTTTCCCACT -> TTATACTCGTTTCCCACTT
CACCACGGACCTGATCGCA -> ACCACGGACCTGATCGCAC
ATTTTTGCCGATGTGCGGT -> TTTTTGCCGATGTGCGGTG
TTCTGACATCAATAACATT -> TCTGACATCAATAACATTT
CATCTAGTGATGCCGGTAC -> ATCTAGTGATGCCGGTACG
GGAAAGACTCAGTAGTATG -> GAAAGACTCAGTAGTATGC
ACACCGCAACAAACGCCGT -> CACCGCAACAAACGCCGTG
TTTTGTTTCTGCTGTTTCT -> TTTGTTTCTGCTGTTTCTC
GAGTTATTAGTTCTTCTGC -> AGTTATTAGTTCTTCTGCT
AAAAGCGTGTGTATACAAT -> AAAGCGTGTGTATACAATC
TGATCTGGGGGCAGCCATG -> GATCTGGGGGCAGCCATGA
CAGAAATTTGCAAGCTCGG -> AGAAATTTGCAAGCTCGGA
AGTGGGCATAAAAAATCAG -> GTGGGCATAAAAAATCAGA
TCCAAATTGCTTAAGTCAC -> CCAAATTGCTTAAGTCACA
CCGTGGATCTAGTCAAATC -> CGTGGATCTAGTCAAATCT
GCGCAAGGTCTCCGTCATA -> CGCAAGGTCTCCGTCATAT
CGAAACTCGCCTTATAAAA -> GAAACTCGCCTTATAAAAC
TTGTATAAGGTCACTGCTT -> TGTATAAGGTCACTGCTTC
AGCCACCAACTAGACTGCT -> GCCACCAACTAGACTGCTC
GGTTACAGCTAAGGGTGTT -> GTTACAGCTAAGGGTGTTC
CGCCAAAGGCCCCACTCTT -> GCCAAAGGCCCCACTCTTC
AAATCAGACCTAGAGCTAT -> AATCAGACCTAGAGCTATG
CACAAGGGCAACAAATATC -> ACAAGGGCAACAAATATCC
ATATTTGTTTCGGTGGAAA -> TATTTGTTTCGGTGGAAAG
TTCCCGTATTGTCCGATAG -> TCCCGTATTGTCCGATAGA
ATGTGGGCTGTTTGCTCCG -> TGTGGGCTGTTTGCTCCGG
AAGAAGGTGTCTCGGAGCT -> AGAAGGTGTCTCGGAGCTA
GGGGGCAGCCATGAATGAC -> GGGGCAGCCATGAATGACT
GGGCTGGGCCTTTTAAGGA -> GGCTGGGCCTTTTAAGGAT
GGACATCAACTACGCCGCC -> GACATCAACTACGCCGCCG
GGGTTACAGCTAAGGGTGT -> GGTTACAGCTAAGGGTGTT
TAACCTTGGCCAATAATTT -> AACCTTGGCCAATAATTTT
TGCTTAAGTCACACCGGGC -> GCTTAAGTCACACCGGGCG
GCTATCTTATAACAAGCGG -> CTATCTTATAACAAGCGGA
CTATCCGTACTGCCGATAT -> TATCCGTACTGCCGATATC
CGTTTTACCCAACGAGCGC -> GTTTTACCCAACGAGCGCA
CTAGTCCGCCTTGTCTGGG -> TAGTCCGCCTTGTCTGGGC
GCCTCGGTTCATTCCCTAT -> CCTCGGTTCATTCCCTATT
ATTGGACGTGTTGGCGATT -> TTGGACGTGTTGGCGATTG
GTGTACGTAAGTCCAACCT -> TGTACGTAAGTCCAACCTC
GCCATACGTTAGCAACTGG -> CCATACGTTAGCAACTGGA
GGAGCGCAAGGTCTCCGTC -> GAGCGCAAGGTCTCCGTCA
GCCAGGGGTTGCTCTTGTA -> CCAGGGGTTGCTCTTGTAT
CGCCATGACGGTAGAGGAC -> GCCATGACGGTAGAGGACG
AATAATTTTTGCCGATGTG -> ATAATTTTTGCCGATGTGC
ACGGCGCCGTGGATCTAGT -> CGGCGCCGTGGATCTAGTC
CCAGGTGTACGTAAGTCCA -> CAGGTGTACGTAAGTCCAA
TCCACAAGGGCAACAAATA -> CCACAAGGGCAACAAATAT
GTCCCAAATCCCGCAGGAT -> TCCCAAATCCCGCAGGATC
CGGTAACCGTCACCGAGCA -> GGTAACCGTCACCGAGCAC
TGCTCCAAATTGCTGACTG -> GCTCCAAATTGCTGACTGT
CATCTTCGTATTGGTTGGT -> ATCTTCGTATTGGTTGGTC
CGTTGGGCTATCTTATAAC -> GTTGGGCTATCTTATAACA
GGAGCTGAGGGCTGGGCCT -> GAGCTGAGGGCTGGGCCTT
GGTTGCTCTTGTATAAGGT -> GTTGCTCTTGTATAAGGTC
AGTGTTGGTGGACCAATCA -> GTGTTGGTGGACCAATCAC
TTGTCACCACGGACCTGAT -> TGTCACCACGGACCTGATC
CATGGTGAATCTAGTCCGC -> ATGGTGAATCTAGTCCGCC
GGATCGCTTCCACTCTGAC -> GATCGCTTCCACTCTGACA
AGTTATTAGTTCTTCTGCT -> GTTATTAGTTCTTCTGCTC
GATCACGAGCGGAGACGAT -> ATCACGAGCGGAGACGATC
ATTCGTCGCGATCACGAGC -> TTCGTCGCGATCACGAGCG
TCACACCGGGCGGAGCGCA -> CACACCGGGCGGAGCGCAA
TGCGGTCCACAAGGGCAAC -> GCGGTCCACAAGGGCAACA
TTAGCAATCGCTGAATCAG -> TAGCAATCGCTGAATCAGT
CTACCTCGCGCGTCGGGTA -> TACCTCGCGCGTCGGGTAA
AGCCATGAATGACTACTCG -> GCCATGAATGACTACTCGG
CAACAAACGCCGTGATTCT -> AACAAACGCCGTGATTCTG
GCCATGACGGTAGAGGACG -> CCATGACGGTAGAGGACGA
AAGATCGCGTAACAAATTC -> AGATCGCGTAACAAATTCT
TGAAAAGCGTGTGTATACA -> GAAAAGCGTGTGTATACAA
ACCTTTAATAATCTCTTCT -> CCTTTAATAATCTCTTCTG
ACGAGCGCAGCGGAACATC -> CGAGCGCAGCGGAACATCT
AACAACTCGGAACAGACGC -> ACAACTCGGAACAGACGCC
TCATTAGGCATTCGATTTT -> CATTAGGCATTCGATTTTT
TAAAGCCACCAACTAGACT -> AAAGCCACCAACTAGACTG
GAACATCTCGCCTTTGATG -> AACATCTCGCCTTTGATGT
ACGATCTGCTGGCTTGGCA -> CGATCTGCTGGCTTGGCAC
GTCCAACCTCGGCTCTGAT -> TCCAACCTCGGCTCTGATG
GCGAACATCTCGCCTTTGA -> CGAACATCTCGCCTTTGAT
CAGCAACCGGGGCGGATGA -> AGCAACCGGGGCGGATGAA
TTTGCGGTCCACAAGGGCA -> TTGCGGTCCACAAGGGCAA
GGCCTCTAGGGCTGAAATG -> GCCTCTAGGGCTGAAATGT
GCAATTCCGTATGTATATA -> CAATTCCGTATGTATATAT
TTCGTCGCGATCACGAGCG -> TCGTCGCGATCACGAGCGG
CGAGTGGCCAGGTGTACGT -> GAGTGGCCAGGTGTACGTA
TGGCGCTCACTGCCGATTC -> GGCGCTCACTGCCGATTCG
TTCTTCTGCTCCAAATTGC -> TCTTCTGCTCCAAATTGCT
ACTCGCTAGAGACCTTTCG -> CTCGCTAGAGACCTTTCGC
TTTCCCACTTGATCGTAAA -> TTCCCACTTGATCGTAAAG
GTGCGGGCGGCCAGCAACC -> TGCGGGCGGCCAGCAACCG
CACGGTAGGGTACTATCGA -> ACGGTAGGGTACTATCGAG
ACTGCTTCGATAAGGTTCC -> CTGCTTCGATAAGGTTCCA
CAAAGCAGAAATTTGCAAG -> AAAGCAGAAATTTGCAAGC
GCGGAGCGCAAGGTCTCCG -> CGGAGCGCAAGGTCTCCGT
TCGTTAAGCCCCCATTACG -> CGTTAAGCCCCCATTACGA
ATGTGGCTACTCATCGCTG -> TGTGGCTACTCATCGCTGG
TGTTCCCATTTGATTTTGT -> GTTCCCATTTGATTTTGTT
GCGGCCAGCAACCGGGGCG -> CGGCCAGCAACCGGGGCGG
CAGAGCCCGTTTTACCCAA -> AGAGCCCGTTTTACCCAAC
TTGGCACTGGATGCGTGGT -> TGGCACTGGATGCGTGGTC
TCCGATAGACGCTCATATG -> CCGATAGACGCTCATATGA
GTATTGTCCGATAGACGCT -> TATTGTCCGATAGACGCTC
TCTTTAACTAAAATCGAAA -> CTTTAACTAAAATCGAAAC
CAACGAGCGCAGCGGAACA -> AACGAGCGCAGCGGAACAT
GGGTCCTTAGGAGTTGGAG -> GGTCCTTAGGAGTTGGAGG
TCGCGTAACAAATTCTCAG -> CGCGTAACAAATTCTCAGA
AGCCAGGGGTTGCTCTTGT -> GCCAGGGGTTGCTCTTGTA
CTCAGATTTAGTTCGCGAA -> TCAGATTTAGTTCGCGAAC
TGGCACCTTTAATAATCTC -> GGCACCTTTAATAATCTCT
CTCATATGAAAAGCGTGTG -> TCATATGAAAAGCGTGTGT
CCACAAGGGCAACAAATAT -> CACAAGGGCAACAAATATC
CATCTCGCCTTTGATGTCC -> ATCTCGCCTTTGATGTCCC
TTGGGTGCGTACAATATCA -> TGGGTGCGTACAATATCAT
ACCTCGCGCGTCGGGTAAC -> CCTCGCGCGTCGGGTAACT
AGTGATTCTACTTTGCGGT -> GTGATTCTACTTTGCGGTC
AACTACGCCGCCGGTAAAC -> ACTACGCCGCCGGTAAACT
GGGCATAAAAAATCAGACC -> GGCATAAAAAATCAGACCT
CGGTAAACTAGTCTCGTTT -> GGTAAACTAGTCTCGTTTT
GATGTGGGCTGTTTGCTCC -> ATGTGGGCTGTTTGCTCCG
AGGGCTGAAATGTAGACGA -> GGGCTGAAATGTAGACGAA
TGACAGTTCTGACTAAGCC -> GACAGTTCTGACTAAGCCT
ATGTCATTACATTGGACGT -> TGTCATTACATTGGACGTG
CGTACAATATCATGGTGAA -> GTACAATATCATGGTGAAT
GGTGCACTCGCTAGAGACC -> GTGCACTCGCTAGAGACCT
ATTAGGCATTCGATTTTTC -> TTAGGCATTCGATTTTTCT
TACTTTGCGGTCCACAAGG -> ACTTTGCGGTCCACAAGGG
GCGTACAATATCATGGTGA -> CGTACAATATCATGGTGAA
CACGAGCGGAGACGATCGG -> ACGAGCGGAGACGATCGGA
GCGTGGTCTTCTGCTCCAA -> CGTGGTCTTCTGCTCCAAA
CTATGGGGTTACAGCTAAG -> TATGGGGTTACAGCTAAGG
TTACCCAACGAGCGCAGCG -> TACCCAACGAGCGCAGCGG
GGTGGCGCTCACTGCCGAT -> GTGGCGCTCACTGCCGATT
GCTCACTGCCGATTCGTCG -> CTCACTGCCGATTCGTCGC
GGAACATCTTCGTATTGGT -> GAACATCTTCGTATTGGTT
GGTGCGTACAATATCATGG -> GTGCGTACAATATCATGGT
CAACAGTTGGCACGAGTTA -> AACAGTTGGCACGAGTTAT
CACTGCCGATTCGTCGCGA -> ACTGCCGATTCGTCGCGAT
TGAGTGGAGGTAGTGTTGG -> GAGTGGAGGTAGTGTTGGT
TTGTCTGGGCTCATCATTA -> TGTCTGGGCTCATCATTAG
AGCCCCCATTACGATCTGC -> GCCCCCATTACGATCTGCT
CTCGAGTGGCCAGGTGTAC -> TCGAGTGGCCAGGTGTACG
CCAGTTGCCATTAGGCGCC -> CAGTTGCCATTAGGCGCCA
TATTCCGCATCGATTGGGT -> ATTCCGCATCGATTGGGTC
TCGATACTGAAAAGGCCTC -> CGATACTGAAAAGGCCTCT
CTTGAAGAAGGTGTCTCGG -> TTGAAGAAGGTGTCTCGGA
CTTTAATAATCTCTTCTGC -> TTTAATAATCTCTTCTGCT
TGTGTATACAATCGTCCAA -> GTGTATACAATCGTCCAAC
TTTCTCGGTAACCGTCACC -> TTCTCGGTAACCGTCACCG
AGCAACAGTTGGCACAGCG -> GCAACAGTTGGCACAGCGG
ACATCTTCGTATTGGTTGG -> CATCTTCGTATTGGTTGGT
TCGGCCATACGTTAGCAAC -> CGGCCATACGTTAGCAACT
CGCCGTGGATCTAGTCAAA -> GCCGTGGATCTAGTCAAAT
GGCGGAGCGCAAGGTCTCC -> GCGGAGCGCAAGGTCTCCG
CTCCAAATTGCTTCCAGCC -> TCCAAATTGCTTCCAGCCA
TGCGTGGTCTTCTGCTCCA -> GCGTGGTCTTCTGCTCCAA
CGGATTTTAAACCTTGAGT -> GGATTTTAAACCTTGAGTG
TGGGTCCTTAGGAGTTGGA -> GGGTCCTTAGGAGTTGGAG
TAAGGATGTAGCAACAGTT -> AAGGATGTAGCAACAGTTG
GAGCACCCCAAACTTCATG -> AGCACCCCAAACTTCATGT
GGCAAGTGTCGCGATGCCT -> GCAAGTGTCGCGATGCCTT
ACGTGCGAGTGGGCATAAA -> CGTGCGAGTGGGCATAAAA
ACATCAACTACGCCGCCGG -> CATCAACTACGCCGCCGGT
AGTCCAACCTCGGCTCTGA -> GTCCAACCTCGGCTCTGAT
AAATCTATCCACACTTTCG -> AATCTATCCACACTTTCGA
GGGCGCTCTTCTGCTCCAA -> GGCGCTCTTCTGCTCCAAA
AAATTGCTTAGTGCGGGCG -> AATTGCTTAGTGCGGGCGG
GTCGCGATGCCTTGAAGAA -> TCGCGATGCCTTGAAGAAG
TTGCAAGCTCGGAAGCCTC -> TGCAAGCTCGGAAGCCTCG
CGCGTAACAAATTCTCAGA -> GCGTAACAAATTCTCAGAT
ATGAAAAGCGTGTGTATAC -> TGAAAAGCGTGTGTATACA
GGAACGGGTGCACTCGCTA -> GAACGGGTGCACTCGCTAG
ACGCTTTCTGTAGCAACAG -> CGCTTTCTGTAGCAACAGT
AGTGGCCAGGTGTACGTAA -> GTGGCCAGGTGTACGTAAG
GCTGACGGTGGCCGGTGTT -> CTGACGGTGGCCGGTGTTA
AGTCCGCCTTGTCTGGGCT -> GTCCGCCTTGTCTGGGCTC
CCGTGATTCTGACATCAAT -> CGTGATTCTGACATCAATA
TCCAACCTCGGCTCTGATG -> CCAACCTCGGCTCTGATGT
AGTATGCTGCCGGCCCTCA -> GTATGCTGCCGGCCCTCAA
CTCTTGAGGGGTTCTCTGG -> TCTTGAGGGGTTCTCTGGG
TCCCACTTGATCGTAAAGC -> CCCACTTGATCGTAAAGCC
TCTGACTAAGCCTTCCCCG -> CTGACTAAGCCTTCCCCGT
ACCTTTCGCTACCTCGCGC -> CCTTTCGCTACCTCGCGCG
CTCCGTCATATGACAATAT -> TCCGTCATATGACAATATT
GCTAACTGATCTCTTGAGG -> CTAACTGATCTCTTGAGGG
TTAGCAACTGGACATCAAC -> TAGCAACTGGACATCAACT
CTCTAGGGCTGAAATGTAG -> TCTAGGGCTGAAATGTAGA
AGAACAACTCGGAACAGAC -> GAACAACTCGGAACAGACG
ACCCGGTCCAGAAACGTTA -> CCCGGTCCAGAAACGTTAG
ACTAGACTGCTCCGGGTAC -> CTAGACTGCTCCGGGTACG
TCTGATGTGGGCTGTTTGC -> CTGATGTGGGCTGTTTGCT
TTGCTGACTGTTAGAGCCG -> TGCTGACTGTTAGAGCCGC
TGTCCGATAGACGCTCATA -> GTCCGATAGACGCTCATAT
CTATCCACACTTTCGATGT -> TATCCACACTTTCGATGTG
GGAGCTAACTGATCTCTTG -> GAGCTAACTGATCTCTTGA
CAAATTCTCAGATTTAGTT -> AAATTCTCAGATTTAGTTC
TTCGCTACCTCGCGCGTCG -> TCGCTACCTCGCGCGTCGG
CCAATAATTTTTGCCGATG -> CAATAATTTTTGCCGATGT
ATCGTCCAACAACATCACC -> TCGTCCAACAACATCACCG
ATATGACAATATTTGTTTC -> TATGACAATATTTGTTTCG
CACCCAGTTGCCATTAGGC -> ACCCAGTTGCCATTAGGCG
GCAGCGGAACATCTTCGTA -> CAGCGGAACATCTTCGTAT
CTGGGGGCAGCCATGAATG -> TGGGGGCAGCCATGAATGA
CAGTTCTGACTAAGCCTTC -> AGTTCTGACTAAGCCTTCC
CTATCTTATAACAAGCGGA -> TATCTTATAACAAGCGGAG
TTCCCACTTGATCGTAAAG -> TCCCACTTGATCGTAAAGC
ATACTCGTTTCCCACTTGA -> TACTCGTTTCCCACTTGAT
CTCATCATTAGGCATTCGA -> TCATCATTAGGCATTCGAT
CGCGAACATCTCGCCTTTG -> GCGAACATCTCGCCTTTGA
TGACTAAGCCTTCCCCGTC -> GACTAAGCCTTCCCCGTCC
ACTGCCGATTCGTCGCGAT -> CTGCCGATTCGTCGCGATC
CTAGACTGCTCCGGGTACG -> TAGACTGCTCCGGGTACGT
AGCTATGGGGTTACAGCTA -> GCTATGGGGTTACAGCTAA
TCAGTATTGTAGTAGAGGG -> CAGTATTGTAGTAGAGGGA
GTAGAGGGAGCTGAGGGCT -> TAGAGGGAGCTGAGGGCTG
AATCGTCCAACAACATCAC -> ATCGTCCAACAACATCACC
ATAATGATCACGGTAGGGT -> TAATGATCACGGTAGGGTA
CCCATTTGATTTTGTTTCT -> CCATTTGATTTTGTTTCTG
TTTTACCCAACGAGCGCAG -> TTTACCCAACGAGCGCAGC
CTGAAATGTAGACGAAACT -> TGAAATGTAGACGAAACTA
CCGGAGTTCTGTGTCCCGG -> CGGAGTTCTGTGTCCCGGT
GATTCTACTTTGCGGTCCA -> ATTCTACTTTGCGGTCCAC
GGTGTTCGAATCGGATTTT -> GTGTTCGAATCGGATTTTA
TAGGCATTCGATTTTTCTC -> AGGCATTCGATTTTTCTCA
AGTAACGAAGATCGCGTAA -> GTAACGAAGATCGCGTAAC
GAGATTCATCACACACCAG -> AGATTCATCACACACCAGT
CGAACATCTCGCCTTTGAT -> GAACATCTCGCCTTTGATG
AATCAGTATTGTAGTAGAG -> ATCAGTATTGTAGTAGAGG
GGTCCTTAGGAGTTGGAGG -> GTCCTTAGGAGTTGGAGGG
CATCACACACCAGTCTTAC -> ATCACACACCAGTCTTACA
AAGGCCCCACTCTTCCGGA -> AGGCCCCACTCTTCCGGAC
CCAACCTCGAGTGGCCAGG -> CAACCTCGAGTGGCCAGGT
GTTCTGTGTCCCGGTAGTG -> TTCTGTGTCCCGGTAGTGA
AGCACTCTAACACACACCG -> GCACTCTAACACACACCGC
CTTCGGTGACAGTTCTGAC -> TTCGGTGACAGTTCTGACT
AATTTGCAAGCTCGGAAGC -> ATTTGCAAGCTCGGAAGCC
TGAGGGGTTCTCTGGGTTC -> GAGGGGTTCTCTGGGTTCA
GAGCCCGTTTTACCCAACG -> AGCCCGTTTTACCCAACGA
GAGTTATACTCGTTTCCCA -> AGTTATACTCGTTTCCCAC
AGACCTAGAGCTATGGGGT -> GACCTAGAGCTATGGGGTT
GCCGGCCCTCAACGTGCGA -> CCGGCCCTCAACGTGCGAG
CCTTTAATAATCTCTTCTG -> CTTTAATAATCTCTTCTGC
CCTCAACGTGCGAGTGGGC -> CTCAACGTGCGAGTGGGCA
TAGGAGTTGGAGGGTGGCG -> AGGAGTTGGAGGGTGGCGC
GAAGGTGTCTCGGAGCTAA -> AAGGTGTCTCGGAGCTAAC
GCTTAAGTCACACCGGGCG -> CTTAAGTCACACCGGGCGG
CACACCAGTCTTACAGCGC -> ACACCAGTCTTACAGCGCC
ATGTAGACGAAACTATTAA -> TGTAGACGAAACTATTAAC
GGATGTGGGTCCTTAGGAG -> GATGTGGGTCCTTAGGAGT
CCGGGCGGAGCGCAAGGTC -> CGGGCGGAGCGCAAGGTCT
GTTCGCGAACATCTCGCCT -> TTCGCGAACATCTCGCCTT
CAGGATCGCTTCCACTCTG -> AGGATCGCTTCCACTCTGA
TACTATCGAGCACTCTAAC -> ACTATCGAGCACTCTAACA
AATCAGACCTAGAGCTATG -> ATCAGACCTAGAGCTATGG
CTCACCTTGTCACCACGGA -> TCACCTTGTCACCACGGAC
ACTCTAACACACACCGCAA -> CTCTAACACACACCGCAAC
CACACTTTCGATGTGGCTA -> ACACTTTCGATGTGGCTAC
AGACGATCGGAGTAACGAA -> GACGATCGGAGTAACGAAG
TCTGGGCTCATCATTAGGC -> CTGGGCTCATCATTAGGCA
AATTTTTGCCGATGTGCGG -> ATTTTTGCCGATGTGCGGT
AGTGATGCCGGTACGCTTT -> GTGATGCCGGTACGCTTTC
TATATACAACTTTGGGTGC -> ATATACAACTTTGGGTGCG
GTGTTCCCATTTGATTTTG -> TGTTCCCATTTGATTTTGT
CCGCTTTGTGTAGCAACAG -> CGCTTTGTGTAGCAACAGT
GCCGCAGTTCTTTAACTAA -> CCGCAGTTCTTTAACTAAA
GAGCTGAGGGCTGGGCCTT -> AGCTGAGGGCTGGGCCTTT
ATTGCTTAAGTCACACCGG -> TTGCTTAAGTCACACCGGG
GAAATTTGCAAGCTCGGAA -> AAATTTGCAAGCTCGGAAG
TCTAACACACACCGCAACA -> CTAACACACACCGCAACAA
GGGTACGTTGGGCTATCTT -> GGTACGTTGGGCTATCTTA
TGAAAGAGATTCATCACAC -> GAAAGAGATTCATCACACA
CGGGTACGTTGGGCTATCT -> GGGTACGTTGGGCTATCTT
TCGGTAACCGTCACCGAGC -> CGGTAACCGTCACCGAGCA
TTCGATAAGGTTCCATACT -> TCGATAAGGTTCCATACTA
ACTCGCCTTATAAAACCCT -> CTCGCCTTATAAAACCCTC
TGTAGCAACAGTTGGCACT -> GTAGCAACAGTTGGCACTG
GCTAGAGACCTTTCGCTAC -> CTAGAGACCTTTCGCTACC
TGGCTACTCATCGCTGGTG -> GGCTACTCATCGCTGGTGT
CACCGCAACAAACGCCGTG -> ACCGCAACAAACGCCGTGA
TCTGCTCCAAATTGCTTAG -> CTGCTCCAAATTGCTTAGT
CTATTCCGCATCGATTGGG -> TATTCCGCATCGATTGGGT
TTACATTGGACGTGTTGGC -> TACATTGGACGTGTTGGCG
GAGTGGGCATAAAAAATCA -> AGTGGGCATAAAAAATCAG
CGGTTCATTCCCTATTCCG -> GGTTCATTCCCTATTCCGC
GCTTTGTGTAGCAACAGTT -> CTTTGTGTAGCAACAGTTG
TGGACATCAACTACGCCGC -> GGACATCAACTACGCCGCC
CGAGTTATACTCGTTTCCC -> GAGTTATACTCGTTTCCCA
GATTTAGTTCGCGAACATC -> ATTTAGTTCGCGAACATCT
TTCGTATTGGTTGGTCATC -> TCGTATTGGTTGGTCATCG
GGCTGATGATCCGCCAACC -> GCTGATGATCCGCCAACCT
AATCCCGCAGGATCGCTTC -> ATCCCGCAGGATCGCTTCC
ACGTAAGTCCAACCTCGGC -> CGTAAGTCCAACCTCGGCT
TATTGGTTGGTCATCGCCG -> ATTGGTTGGTCATCGCCGC
CTCGGCCATACGTTAGCAA -> TCGGCCATACGTTAGCAAC
AAACTATTAACCCGGTCCA -> AACTATTAACCCGGTCCAG
TGTATAAGGTCACTGCTTC -> GTATAAGGTCACTGCTTCG
TATGCTGCCGGCCCTCAAC -> ATGCTGCCGGCCCTCAACG
TGGGCAAGTGTCGCGATGC -> GGGCAAGTGTCGCGATGCC
ACGAAACTATTAACCCGGT -> CGAAACTATTAACCCGGTC
TCCGGGTACGTTGGGCTAT -> CCGGGTACGTTGGGCTATC
GGAGGGTGGCGCTCACTGC -> GAGGGTGGCGCTCACTGCC
AACAAACGCCGTGATTCTG -> ACAAACGCCGTGATTCTGA
TGGTGGACCAATCACGTGA -> GGTGGACCAATCACGTGAT
TCCCCGTCCCAGGCAACCT -> CCCCGTCCCAGGCAACCTG
TGCTGACGGTGGCCGGTGT -> GCTGACGGTGGCCGGTGTT
ATCAATAACATTTACCCGC -> TCAATAACATTTACCCGCA
TGCTGCCGGCCCTCAACGT -> GCTGCCGGCCCTCAACGTG
CAAAGGCCCCACTCTTCCG -> AAAGGCCCCACTCTTCCGG
CCGCATCGATTGGGTCGTT -> CGCATCGATTGGGTCGTTA
TGAATCAGTATTGTAGTAG -> GAATCAGTATTGTAGTAGA
GCAGGCTGATGATCCGCCA -> CAGGCTGATGATCCGCCAA
ATCACGTGATCTTCGGTGA -> TCACGTGATCTTCGGTGAC
GCTTCCACTCTGACAGAGC -> CTTCCACTCTGACAGAGCC
ACAATATCATGGTGAATCT -> CAATATCATGGTGAATCTA
TGACGGTGGCCGGTGTTAG -> GACGGTGGCCGGTGTTAGC
GGTGGCCGGTGTTAGCAAT -> GTGGCCGGTGTTAGCAATT
GCTCTGATGTGGGCTGTTT -> CTCTGATGTGGGCTGTTTG
AGCTAAGGGTGTTCCCATT -> GCTAAGGGTGTTCCCATTT
ACCTGATCGCACAGGAGAA -> CCTGATCGCACAGGAGAAC
ATCTAGTCCGCCTTGTCTG -> TCTAGTCCGCCTTGTCTGG
AATCGAAACTCGCCTTATA -> ATCGAAACTCGCCTTATAA
TCAATAACATTTACCCGCA -> CAATAACATTTACCCGCAT
CCCCCCGAGTTATACTCGT -> CCCCCGAGTTATACTCGTT
CGCACAGGAGAACAACTCG -> GCACAGGAGAACAACTCGG
AGACTGCTCCGGGTACGTT -> GACTGCTCCGGGTACGTTG
TTGGACGTGTTGGCGATTG -> TGGACGTGTTGGCGATTGA
TTACAGCTAAGGGTGTTCC -> TACAGCTAAGGGTGTTCCC
CACTGGATGCGTGGTCTTC -> ACTGGATGCGTGGTCTTCT
GCAACAAACGCCGTGATTC -> CAACAAACGCCGTGATTCT
CCGATTCGTCGCGATCACG -> CGATTCGTCGCGATCACGA
GGTGGAAAGACTCAGTAGT -> GTGGAAAGACTCAGTAGTA
AAATCGAAACTCGCCTTAT -> AATCGAAACTCGCCTTATA
TGCGTACAATATCATGGTG -> GCGTACAATATCATGGTGA
TAGTCCGCCTTGTCTGGGC -> AGTCCGCCTTGTCTGGGCT
ACTATCGAGCACTCTAACA -> CTATCGAGCACTCTAACAC
TTCTGGGGAACAGTAGATA -> TCTGGGGAACAGTAGATAA
GTTTCCCACTTGATCGTAA -> TTTCCCACTTGATCGTAAA
GCGATGCCTTGAAGAAGGT -> CGATGCCTTGAAGAAGGTG
CATCATTAGGCATTCGATT -> ATCATTAGGCATTCGATTT
ACCGAGCACCCCAAACTTC -> CCGAGCACCCCAAACTTCA
TAACACACACCGCAACAAA -> AACACACACCGCAACAAAC
GCCGGTAAACTAGTCTCGT -> CCGGTAAACTAGTCTCGTT
AGGGCTGGGCCTTTTAAGG -> GGGCTGGGCCTTTTAAGGA
CCCCATTACGATCTGCTGG -> CCCATTACGATCTGCTGGC
CCTAGAGCTATGGGGTTAC -> CTAGAGCTATGGGGTTACA
GGCTATCTTATAACAAGCG -> GCTATCTTATAACAAGCGG
ACAAATATCCGCTGCTGAC -> CAAATATCCGCTGCTGACG
CAGCCAGGGGTTGCTCTTG -> AGCCAGGGGTTGCTCTTGT
TTCATCGATACTGAAAAGG -> TCATCGATACTGAAAAGGC
TGGCCAGGTGTACGTAAGT -> GGCCAGGTGTACGTAAGTC
TGACATCAATAACATTTAC -> GACATCAATAACATTTACC
GACCAATCACGTGATCTTC -> ACCAATCACGTGATCTTCG
TCGATGTGGCTACTCATCG -> CGATGTGGCTACTCATCGC
GACCACCTTCAACTTCTGG -> ACCACCTTCAACTTCTGGG
CTCGCGCGTCGGGTAACTA -> TCGCGCGTCGGGTAACTAT
ATGTCCCAAATCCCGCAGG -> TGTCCCAAATCCCGCAGGA
CAACATCACCGGAGTTCTG -> AACATCACCGGAGTTCTGT
TGGACCAATCACGTGATCT -> GGACCAATCACGTGATCTT
CTCGGTAACCGTCACCGAG -> TCGGTAACCGTCACCGAGC
CATTGGACGTGTTGGCGAT -> ATTGGACGTGTTGGCGATT
AGGCCTCTAGGGCTGAAAT -> GGCCTCTAGGGCTGAAATG
CCCGCAGGATCGCTTCCAC -> CCGCAGGATCGCTTCCACT
TTCTGCTGTTTCTCGGTAA -> TCTGCTGTTTCTCGGTAAC
GTAGTAGAGGGAGCTGAGG -> TAGTAGAGGGAGCTGAGGG
GGGCTGAAATGTAGACGAA -> GGCTGAAATGTAGACGAAA
GCGCCATGACGGTAGAGGA -> CGCCATGACGGTAGAGGAC
TGGAAAGACTCAGTAGTAT -> GGAAAGACTCAGTAGTATG
GCTCCGGAGTGGGCAAGTG -> CTCCGGAGTGGGCAAGTGT
ACTACTCGGCCATACGTTA -> CTACTCGGCCATACGTTAG
AAGCGGAGCAAAGCAGAAA -> AGCGGAGCAAAGCAGAAAT
TCCAAATTGCTGACTGTTA -> CCAAATTGCTGACTGTTAG
TGAATGACTACTCGGCCAT -> GAATGACTACTCGGCCATA
GGTTGGTGTCGTGGCGGTA -> GTTGGTGTCGTGGCGGTAT
GGGGCAGCCATGAATGACT -> GGGCAGCCATGAATGACTA
TGATGTCCCAAATCCCGCA -> GATGTCCCAAATCCCGCAG
CTGCCGATTCGTCGCGATC -> TGCCGATTCGTCGCGATCA
TCCTTAGGAGTTGGAGGGT -> CCTTAGGAGTTGGAGGGTG
CAATCACGTGATCTTCGGT -> AATCACGTGATCTTCGGTG
ACAGTTGGCACAGCGGGGG -> CAGTTGGCACAGCGGGGGC
GTATACAATCGTCCAACAA -> TATACAATCGTCCAACAAC
TGATCTTCGGTGACAGTTC -> GATCTTCGGTGACAGTTCT
AACTAGTCTCGTTTTGGTC -> ACTAGTCTCGTTTTGGTCC
TTAGTTCGCGAACATCTCG -> TAGTTCGCGAACATCTCGC
GTACGCTTTCTGTAGCAAC -> TACGCTTTCTGTAGCAACA
GCCAGGTGTACGTAAGTCC -> CCAGGTGTACGTAAGTCCA
TTTCGGACGGCGCCGTGGA -> TTCGGACGGCGCCGTGGAT
GCCCCACTCTTCCGGACCA -> CCCCACTCTTCCGGACCAC
TATGAAAAGCGTGTGTATA -> ATGAAAAGCGTGTGTATAC
CGCTTCCACTCTGACAGAG -> GCTTCCACTCTGACAGAGC
GAGTTCTGTGTCCCGGTAG -> AGTTCTGTGTCCCGGTAGT
CTGTAGCAACAGTTGGCAC -> TGTAGCAACAGTTGGCACC
GGGTTGCTCTTGTATAAGG -> GGTTGCTCTTGTATAAGGT
CGGTAGAGGACGATCTGGA -> GGTAGAGGACGATCTGGAT
TACTGAAAAGGCCTCTAGG -> ACTGAAAAGGCCTCTAGGG
AACGTGCGAGTGGGCATAA -> ACGTGCGAGTGGGCATAAA
AAAAATCAGACCTAGAGCT -> AAAATCAGACCTAGAGCTA
GGGCGGATGAAAGAGATTC -> GGCGGATGAAAGAGATTCA
CGTATTGGTTGGTCATCGC -> GTATTGGTTGGTCATCGCC
ATTCCGTATGTATATATTA -> TTCCGTATGTATATATTAG
TGATGATCCGCCAACCTCG -> GATGATCCGCCAACCTCGA
GATGCGTGGTCTTCTGCTC -> ATGCGTGGTCTTCTGCTCC
TAGCAACAGTTGGCACAGC -> AGCAACAGTTGGCACAGCG
AAACGCCGTGATTCTGACA -> AACGCCGTGATTCTGACAT
TAGAGGACGATCTGGATGT -> AGAGGACGATCTGGATGTG
AGGGTGGCGCTCACTGCCG -> GGGTGGCGCTCACTGCCGA
GCCAGCAACCGGGGCGGAT -> CCAGCAACCGGGGCGGATG
TTGCCATTAGGCGCCAAAG -> TGCCATTAGGCGCCAAAGG
ATACAATCGTCCAACAACA -> TACAATCGTCCAACAACAT
TATCCACACTTTCGATGTG -> ATCCACACTTTCGATGTGG
GGCTGGGCCTTTTAAGGAT -> GCTGGGCCTTTTAAGGATG
ACTACGCCGCCGGTAAACT -> CTACGCCGCCGGTAAACTA
ATCTAGTCAAATCTATCCA -> TCTAGTCAAATCTATCCAC
TACGATCTGCTGGCTTGGC -> ACGATCTGCTGGCTTGGCA
ATCACACACCAGTCTTACA -> TCACACACCAGTCTTACAG
CACACACCAGTCTTACAGC -> ACACACCAGTCTTACAGCG
AATCACGTGATCTTCGGTG -> ATCACGTGATCTTCGGTGA
TGGGCCTTTTAAGGATGTA -> GGGCCTTTTAAGGATGTAG
TTAGTGCGGGCGGCCAGCA -> TAGTGCGGGCGGCCAGCAA
CCTCTTCCCGTATTGTCCG -> CTCTTCCCGTATTGTCCGA
GAAACGTTAGCAATCGCTG -> AAACGTTAGCAATCGCTGA
GGTCCCCCCGAGTTATACT -> GTCCCCCCGAGTTATACTC
CCCAAATCCCGCAGGATCG -> CCAAATCCCGCAGGATCGC
CGCCTTTGATGTCCCAAAT -> GCCTTTGATGTCCCAAATC
TGATCTCTTGAGGGGTTCT -> GATCTCTTGAGGGGTTCTC
TCGAGTGGCCAGGTGTACG -> CGAGTGGCCAGGTGTACGT
CTCGCCTTTGATGTCCCAA -> TCGCCTTTGATGTCCCAAA
CCATACGTTAGCAACTGGA -> CATACGTTAGCAACTGGAC
GGGCAAGTGTCGCGATGCC -> GGCAAGTGTCGCGATGCCT
TTATACTCGTTTCCCACTT -> TATACTCGTTTCCCACTTG
CCTTCAACTTCTGGGGAAC -> CTTCAACTTCTGGGGAACA
AACAGTTGGCACGAGTTAT -> ACAGTTGGCACGAGTTATT
GCGCCAAAGGCCCCACTCT -> CGCCAAAGGCCCCACTCTT
TGACTACTCGGCCATACGT -> GACTACTCGGCCATACGTT
TTTTTGCCGATGTGCGGTG -> TTTTGCCGATGTGCGGTGA
GACGGCGCCGTGGATCTAG -> ACGGCGCCGTGGATCTAGT
GTCAAATCTATCCACACTT -> TCAAATCTATCCACACTTT
GCGATTGACCGCTAACTTT -> CGATTGACCGCTAACTTTC
ACTAAAATCGAAACTCGCC -> CTAAAATCGAAACTCGCCT
TGCTCTTGTATAAGGTCAC -> GCTCTTGTATAAGGTCACT
ACAGAGCCCGTTTTACCCA -> CAGAGCCCGTTTTACCCAA
TCTAGTCCGCCTTGTCTGG -> CTAGTCCGCCTTGTCTGGG
TTTACCCGCATCTAGTGAT -> TTACCCGCATCTAGTGATG
TGGTCCCCCCGAGTTATAC -> GGTCCCCCCGAGTTATACT
GACCTTTCGCTACCTCGCG -> ACCTTTCGCTACCTCGCGC
GCGGTATATACAACTTTGG -> CGGTATATACAACTTTGGG
CAGATTTAGTTCGCGAACA -> AGATTTAGTTCGCGAACAT
CCGCATCTAGTGATGCCGG -> CGCATCTAGTGATGCCGGT
CGAGCACCCCAAACTTCAT -> GAGCACCCCAAACTTCATG
GCACCCAGTTGCCATTAGG -> CACCCAGTTGCCATTAGGC
GACGCCGGAACGGGTGCAC -> ACGCCGGAACGGGTGCACT
AGTAGATAATGATCACGGT -> GTAGATAATGATCACGGTA
GTTCTTCTGCTCCAAATTG -> TTCTTCTGCTCCAAATTGC
ATATACAACTTTGGGTGCG -> TATACAACTTTGGGTGCGT
CCGCTGCTGACGGTGGCCG -> CGCTGCTGACGGTGGCCGG
TGCTCCAAATTGCTTAAGT -> GCTCCAAATTGCTTAAGTC
TATTTGTTTCGGTGGAAAG -> ATTTGTTTCGGTGGAAAGA
GGGCCTTTTAAGGATGTAG -> GGCCTTTTAAGGATGTAGC
GGGTACTATCGAGCACTCT -> GGTACTATCGAGCACTCTA
ATCGATACTGAAAAGGCCT -> TCGATACTGAAAAGGCCTC
CGCAGCGGAACATCTTCGT -> GCAGCGGAACATCTTCGTA
AGAAACGTTAGCAATCGCT -> GAAACGTTAGCAATCGCTG
GTGGGCATAAAAAATCAGA -> TGGGCATAAAAAATCAGAC
ACGCCGTGATTCTGACATC -> CGCCGTGATTCTGACATCA
TTTGCAAGCTCGGAAGCCT -> TTGCAAGCTCGGAAGCCTC
TCGGAGTAACGAAGATCGC -> CGGAGTAACGAAGATCGCG
GTGATGCCGGTACGCTTTC -> TGATGCCGGTACGCTTTCT
TGGATGCGTGGTCTTCTGC -> GGATGCGTGGTCTTCTGCT
GAACAGACGCCGGAACGGG -> AACAGACGCCGGAACGGGT
ACGAGCGGAGACGATCGGA -> CGAGCGGAGACGATCGGAG
GGGGTTCTCTGGGTTCATC -> GGGTTCTCTGGGTTCATCG
CACCAGTCTTACAGCGCCA -> ACCAGTCTTACAGCGCCAT
TATAAAACCCTCTTCCCGT -> ATAAAACCCTCTTCCCGTA
GTTTGCTCCGGAGTGGGCA -> TTTGCTCCGGAGTGGGCAA
TTAATAATCTCTTCTGCTC -> TAATAATCTCTTCTGCTCC
GAAAGACTCAGTAGTATGC -> AAAGACTCAGTAGTATGCT
GTATGTATATATTAGAAGA -> TATGTATATATTAGAAGAG
GCAACAGTTGGCACGAGTT -> CAACAGTTGGCACGAGTTA
GAAACTCGCCTTATAAAAC -> AAACTCGCCTTATAAAACC
ATTTTGTTTCTGCTGTTTC -> TTTTGTTTCTGCTGTTTCT
ATCATTAGGCATTCGATTT -> TCATTAGGCATTCGATTTT
GTGACAGTTCTGACTAAGC -> TGACAGTTCTGACTAAGCC
ACTGCCGATATCCTTGTAG -> CTGCCGATATCCTTGTAGC
CAATCGTCCAACAACATCA -> AATCGTCCAACAACATCAC
GTTGGCACGAGTTATTAGT -> TTGGCACGAGTTATTAGTT
TTTCTGCTGTTTCTCGGTA -> TTCTGCTGTTTCTCGGTAA
TCATATGACAATATTTGTT -> CATATGACAATATTTGTTT
ATGAAAGAGATTCATCACA -> TGAAAGAGATTCATCACAC
AGTTGGCACCTTTAATAAT -> GTTGGCACCTTTAATAATC
TGTAGCAACAGTTGGCACG -> GTAGCAACAGTTGGCACGA
ATGCGTGGTCTTCTGCTCC -> TGCGTGGTCTTCTGCTCCA
GTCCAGAAACGTTAGCAAT -> TCCAGAAACGTTAGCAATC
CAAGGTCTCCGTCATATGA -> AAGGTCTCCGTCATATGAC
ACGGGTGCACTCGCTAGAG -> CGGGTGCACTCGCTAGAGA
AACGTTAGCAATCGCTGAA -> ACGTTAGCAATCGCTGAAT
TGGGTTCATCGATACTGAA -> GGGTTCATCGATACTGAAA
CGGTGATCTGGGGGCAGCC -> GGTGATCTGGGGGCAGCCA
TTCTACTTTGCGGTCCACA -> TCTACTTTGCGGTCCACAA
GGCCAATAATTTTTGCCGA -> GCCAATAATTTTTGCCGAT
TAAGGGTGTTCCCATTTGA -> AAGGGTGTTCCCATTTGAT
TAACTTTCGGACGGCGCCG -> AACTTTCGGACGGCGCCGT
CCTTAGGAGTTGGAGGGTG -> CTTAGGAGTTGGAGGGTGG
CTCGCTAGAGACCTTTCGC -> TCGCTAGAGACCTTTCGCT
TATGACAATATTTGTTTCG -> ATGACAATATTTGTTTCGG
TGTTCGAATCGGATTTTAA -> GTTCGAATCGGATTTTAAA
TTGTTTCGGTGGAAAGACT -> TGTTTCGGTGGAAAGACTC
CGGGCGGAGCGCAAGGTCT -> GGGCGGAGCGCAAGGTCTC
TCGTTTCCCACTTGATCGT -> CGTTTCCCACTTGATCGTA
TCGCTGGTGTTCGAATCGG -> CGCTGGTGTTCGAATCGGA
AACGAAGATCGCGTAACAA -> ACGAAGATCGCGTAACAAA
AAGGGTGTTCCCATTTGAT -> AGGGTGTTCCCATTTGATT
TTCTGTAGCAACAGTTGGC -> TCTGTAGCAACAGTTGGCA
CAAATTGCTTCCAGCCAGG -> AAATTGCTTCCAGCCAGGG
TCCAGCCAGGGGTTGCTCT -> CCAGCCAGGGGTTGCTCTT
AGTCACACCGGGCGGAGCG -> GTCACACCGGGCGGAGCGC
CGCAAGGTCTCCGTCATAT -> GCAAGGTCTCCGTCATATG
GATACTGAAAAGGCCTCTA -> ATACTGAAAAGGCCTCTAG
GGGCAGCCATGAATGACTA -> GGCAGCCATGAATGACTAC
AGGAGAACAACTCGGAACA -> GGAGAACAACTCGGAACAG
GGGTTCTCTGGGTTCATCG -> GGTTCTCTGGGTTCATCGA
GTTTCGGTGGAAAGACTCA -> TTTCGGTGGAAAGACTCAG
GTGGCCAGGTGTACGTAAG -> TGGCCAGGTGTACGTAAGT
TATACTCGTTTCCCACTTG -> ATACTCGTTTCCCACTTGA
TGGGCATAAAAAATCAGAC -> GGGCATAAAAAATCAGACC
AAACTAGTCTCGTTTTGGT -> AACTAGTCTCGTTTTGGTC
CATGACGGTAGAGGACGAT -> ATGACGGTAGAGGACGATC
AAGCGTGTGTATACAATCG -> AGCGTGTGTATACAATCGT
GAAGATCGCGTAACAAATT -> AAGATCGCGTAACAAATTC
GGCACGAGTTATTAGTTCT -> GCACGAGTTATTAGTTCTT
AGGCGCCAAAGGCCCCACT -> GGCGCCAAAGGCCCCACTC
ATTTTTCTCACCTTGTCAC -> TTTTTCTCACCTTGTCACC
GACAGAGCCCGTTTTACCC -> ACAGAGCCCGTTTTACCCA
TGTAGCAACAGTTGGCACA -> GTAGCAACAGTTGGCACAG
TCCACTCTGACAGAGCCCG -> CCACTCTGACAGAGCCCGT
CCCCGAGTTATACTCGTTT -> CCCGAGTTATACTCGTTTC
GCCGATTCGTCGCGATCAC -> CCGATTCGTCGCGATCACG
GCTACTCATCGCTGGTGTT -> CTACTCATCGCTGGTGTTC
ACTATTAACCCGGTCCAGA -> CTATTAACCCGGTCCAGAA
GCTATGGGGTTACAGCTAA -> CTATGGGGTTACAGCTAAG
GAAAAGGCCTCTAGGGCTG -> AAAAGGCCTCTAGGGCTGA
CAGTTCTTTAACTAAAATC -> AGTTCTTTAACTAAAATCG
GCGCCGTGGATCTAGTCAA -> CGCCGTGGATCTAGTCAAA
ACTAGTCTCGTTTTGGTCC -> CTAGTCTCGTTTTGGTCCC
ACACTTTCGATGTGGCTAC -> CACTTTCGATGTGGCTACT
GATTCTGACATCAATAACA -> ATTCTGACATCAATAACAT
ATCTTCGGTGACAGTTCTG -> TCTTCGGTGACAGTTCTGA
GAGCACTCTAACACACACC -> AGCACTCTAACACACACCG
GACAATATTTGTTTCGGTG -> ACAATATTTGTTTCGGTGG
CCTTATAAAACCCTCTTCC -> CTTATAAAACCCTCTTCCC
AATGTAGACGAAACTATTA -> ATGTAGACGAAACTATTAA
AACTCGGAACAGACGCCGG -> ACTCGGAACAGACGCCGGA
ACACCGGGCGGAGCGCAAG -> CACCGGGCGGAGCGCAAGG
ACAACTTTGGGTGCGTACA -> CAACTTTGGGTGCGTACAA
TACAGCTAAGGGTGTTCCC -> ACAGCTAAGGGTGTTCCCA
AATCGGATTTTAAACCTTG -> ATCGGATTTTAAACCTTGA
CTCGCCTTATAAAACCCTC -> TCGCCTTATAAAACCCTCT
AAGGTCACTGCTTCGATAA -> AGGTCACTGCTTCGATAAG
GCGGTGATCTGGGGGCAGC -> CGGTGATCTGGGGGCAGCC
CAAGCGGAGCAAAGCAGAA -> AAGCGGAGCAAAGCAGAAA
ACCTTGAGTGGAGGTAGTG -> CCTTGAGTGGAGGTAGTGT
CGTACTGCCGATATCCTTG -> GTACTGCCGATATCCTTGT
TGTCACCACGGACCTGATC -> GTCACCACGGACCTGATCG
GCTCTTGTATAAGGTCACT -> CTCTTGTATAAGGTCACTG
GCCAACCTCGAGTGGCCAG -> CCAACCTCGAGTGGCCAGG
CGGAGTGGGCAAGTGTCGC -> GGAGTGGGCAAGTGTCGCG
CGATAGACGCTCATATGAA -> GATAGACGCTCATATGAAA
GTCGTTAAGCCCCCATTAC -> TCGTTAAGCCCCCATTACG
AGGTGTCTCGGAGCTAACT -> GGTGTCTCGGAGCTAACTG
TGCGGTGATCTGGGGGCAG -> GCGGTGATCTGGGGGCAGC
ATTAGTTCTTCTGCTCCAA -> TTAGTTCTTCTGCTCCAAA
TGGCCAATAATTTTTGCCG -> GGCCAATAATTTTTGCCGA
GGCCTTTTAAGGATGTAGC -> GCCTTTTAAGGATGTAGCA
ACGCCGGAACGGGTGCACT -> CGCCGGAACGGGTGCACTC
AACAACATCACCGGAGTTC -> ACAACATCACCGGAGTTCT
ATTACATTGGACGTGTTGG -> TTACATTGGACGTGTTGGC
GTTGGCACTGGATGCGTGG -> TTGGCACTGGATGCGTGGT
TGCTTCGATAAGGTTCCAT -> GCTTCGATAAGGTTCCATA
TAGATAATGATCACGGTAG -> AGATAATGATCACGGTAGG
CAAGGGCAACAAATATCCG -> AAGGGCAACAAATATCCGC
ATAATTTTTGCCGATGTGC -> TAATTTTTGCCGATGTGCG
ATCTTCGTATTGGTTGGTC -> TCTTCGTATTGGTTGGTCA
TCATGGTGAATCTAGTCCG -> CATGGTGAATCTAGTCCGC
AACAGTTGGCACCTTTAAT -> ACAGTTGGCACCTTTAATA
AGGGAGCTGAGGGCTGGGC -> GGGAGCTGAGGGCTGGGCC
AAACTTCATGTCATTACAT -> AACTTCATGTCATTACATT
CTGGCGGTTGGTGTCGTGG -> TGGCGGTTGGTGTCGTGGC
CTGATGATCCGCCAACCTC -> TGATGATCCGCCAACCTCG
AGTCAAATCTATCCACACT -> GTCAAATCTATCCACACTT
CTGCTCCAAATTGCTTAGT -> TGCTCCAAATTGCTTAGTG
TACAATCGTCCAACAACAT -> ACAATCGTCCAACAACATC
CTCTTGTATAAGGTCACTG -> TCTTGTATAAGGTCACTGC
CCAACTAGACTGCTCCGGG -> CAACTAGACTGCTCCGGGT
TTTTAAACCTTGAGTGGAG -> TTTAAACCTTGAGTGGAGG
CTTTGCGGTCCACAAGGGC -> TTTGCGGTCCACAAGGGCA
TAGAGGGAGCTGAGGGCTG -> AGAGGGAGCTGAGGGCTGG
TAGAGCTATGGGGTTACAG -> AGAGCTATGGGGTTACAGC
GTGGGTCCTTAGGAGTTGG -> TGGGTCCTTAGGAGTTGGA
GCTCTTCTGCTCCAAATTG -> CTCTTCTGCTCCAAATTGC
CCTTGTAGCAACAGTTGGC -> CTTGTAGCAACAGTTGGCA
GGCGGCCAGCAACCGGGGC -> GCGGCCAGCAACCGGGGCG
CCAGAAACGTTAGCAATCG -> CAGAAACGTTAGCAATCGC
TGATCACGGTAGGGTACTA -> GATCACGGTAGGGTACTAT
ATCGCTGAATCAGTATTGT -> TCGCTGAATCAGTATTGTA
TTCATTCCCTATTCCGCAT -> TCATTCCCTATTCCGCATC
TCCCGCAGGATCGCTTCCA -> CCCGCAGGATCGCTTCCAC
TGTGGGTCCTTAGGAGTTG -> GTGGGTCCTTAGGAGTTGG
GTATAAGGTCACTGCTTCG -> TATAAGGTCACTGCTTCGA
CTCTTCCCGTATTGTCCGA -> TCTTCCCGTATTGTCCGAT
TGCTCCAAATTGCTTCCAG -> GCTCCAAATTGCTTCCAGC
CAACTAGACTGCTCCGGGT -> AACTAGACTGCTCCGGGTA
GCGGGCGGCCAGCAACCGG -> CGGGCGGCCAGCAACCGGG
CGATCTGCTGGCTTGGCAC -> GATCTGCTGGCTTGGCACC
TACTGCCGATATCCTTGTA -> ACTGCCGATATCCTTGTAG
TAATGATCACGGTAGGGTA -> AATGATCACGGTAGGGTAC
CGCCGGAACGGGTGCACTC -> GCCGGAACGGGTGCACTCG
GATCTGGATGTGGGTCCTT -> ATCTGGATGTGGGTCCTTA
GGCCATACGTTAGCAACTG -> GCCATACGTTAGCAACTGG
CCCCCATTACGATCTGCTG -> CCCCATTACGATCTGCTGG
GTCGCGATCACGAGCGGAG -> TCGCGATCACGAGCGGAGA
GCTCCAAATTGCTTAGTGC -> CTCCAAATTGCTTAGTGCG
TGTTGGTGGACCAATCACG -> GTTGGTGGACCAATCACGT
GAAACTATTAACCCGGTCC -> AAACTATTAACCCGGTCCA
GTGTAGCAACAGTTGGCAC -> TGTAGCAACAGTTGGCACG
CTGTTAGAGCCGCTTTGTG -> TGTTAGAGCCGCTTTGTGT
GTTAGCAATTCCGTATGTA -> TTAGCAATTCCGTATGTAT
TGTGTCCCGGTAGTGATTC -> GTGTCCCGGTAGTGATTCT
CACGAGTTATTAGTTCTTC -> ACGAGTTATTAGTTCTTCT
CGTGTTGGCGATTGACCGC -> GTGTTGGCGATTGACCGCT
ATTGCTTCCAGCCAGGGGT -> TTGCTTCCAGCCAGGGGTT
AATTGCTGACTGTTAGAGC -> ATTGCTGACTGTTAGAGCC
TGATCCGCCAACCTCGAGT -> GATCCGCCAACCTCGAGTG
GATCTTCGGTGACAGTTCT -> ATCTTCGGTGACAGTTCTG
CTTTTAAGGATGTAGCAAC -> TTTTAAGGATGTAGCAACA
GATAATGATCACGGTAGGG -> ATAATGATCACGGTAGGGT
CTCGTTTCCCACTTGATCG -> TCGTTTCCCACTTGATCGT
TAATAATCTCTTCTGCTCC -> AATAATCTCTTCTGCTCCA
GATCGCACAGGAGAACAAC -> ATCGCACAGGAGAACAACT
TCGAATCGGATTTTAAACC -> CGAATCGGATTTTAAACCT
ATAAAACCCTCTTCCCGTA -> TAAAACCCTCTTCCCGTAT
TCACTGCTTCGATAAGGTT -> CACTGCTTCGATAAGGTTC
AGGCCCCACTCTTCCGGAC -> GGCCCCACTCTTCCGGACC
ACTGGACATCAACTACGCC -> CTGGACATCAACTACGCCG
AAATTGCTTCCAGCCAGGG -> AATTGCTTCCAGCCAGGGG
ACCACGGACCTGATCGCAC -> CCACGGACCTGATCGCACA
TTTTGGTCCCCCCGAGTTA -> TTTGGTCCCCCCGAGTTAT
AAGGTTCCATACTAACCTT -> AGGTTCCATACTAACCTTG
ACTGAAAAGGCCTCTAGGG -> CTGAAAAGGCCTCTAGGGC
ATTCCGCATCGATTGGGTC -> TTCCGCATCGATTGGGTCG
TTGATTTTGTTTCTGCTGT -> TGATTTTGTTTCTGCTGTT
GGAAGCCTCGGTTCATTCC -> GAAGCCTCGGTTCATTCCC
AGCAACCGGGGCGGATGAA -> GCAACCGGGGCGGATGAAA
ATGACGGTAGAGGACGATC -> TGACGGTAGAGGACGATCT
CAAATTGCTGACTGTTAGA -> AAATTGCTGACTGTTAGAG
AATCGCTGAATCAGTATTG -> ATCGCTGAATCAGTATTGT
TCCGCTGCTGACGGTGGCC -> CCGCTGCTGACGGTGGCCG
GGCAACAAATATCCGCTGC -> GCAACAAATATCCGCTGCT
CTGGGCCTTTTAAGGATGT -> TGGGCCTTTTAAGGATGTA
CAGTTGGCACAGCGGGGGC -> AGTTGGCACAGCGGGGGCG
GGTACGTTGGGCTATCTTA -> GTACGTTGGGCTATCTTAT
TCTCGCCTTTGATGTCCCA -> CTCGCCTTTGATGTCCCAA
GCCCTCAACGTGCGAGTGG -> CCCTCAACGTGCGAGTGGG
AGGGTACTATCGAGCACTC -> GGGTACTATCGAGCACTCT
TCAAATCTATCCACACTTT -> CAAATCTATCCACACTTTC
GGCATTCGATTTTTCTCAC -> GCATTCGATTTTTCTCACC
GTTGGTGTCGTGGCGGTAT -> TTGGTGTCGTGGCGGTATA
GGGGCGCTCTTCTGCTCCA -> GGGCGCTCTTCTGCTCCAA
GCACAGGAGAACAACTCGG -> CACAGGAGAACAACTCGGA
CGGAGTAACGAAGATCGCG -> GGAGTAACGAAGATCGCGT
CGATTGGGTCGTTAAGCCC -> GATTGGGTCGTTAAGCCCC
ATAATCTCTTCTGCTCCAA -> TAATCTCTTCTGCTCCAAA
TGACAATATTTGTTTCGGT -> GACAATATTTGTTTCGGTG
ACCTCGGCTCTGATGTGGG -> CCTCGGCTCTGATGTGGGC
CTGCTGGCTTGGCACCCAG -> TGCTGGCTTGGCACCCAGT
AGTAGAGGGAGCTGAGGGC -> GTAGAGGGAGCTGAGGGCT
AAAGCAGAAATTTGCAAGC -> AAGCAGAAATTTGCAAGCT
CTGGACATCAACTACGCCG -> TGGACATCAACTACGCCGC
ATCAACTACGCCGCCGGTA -> TCAACTACGCCGCCGGTAA
CGTGCGAGTGGGCATAAAA -> GTGCGAGTGGGCATAAAAA
GCGGATGAAAGAGATTCAT -> CGGATGAAAGAGATTCATC
GGCTGTTTGCTCCGGAGTG -> GCTGTTTGCTCCGGAGTGG
GAATGACTACTCGGCCATA -> AATGACTACTCGGCCATAC
AGGTGTACGTAAGTCCAAC -> GGTGTACGTAAGTCCAACC
CGTTTCCCACTTGATCGTA -> GTTTCCCACTTGATCGTAA
ATATCCTTGTAGCAACAGT -> TATCCTTGTAGCAACAGTT
CAAATATCCGCTGCTGACG -> AAATATCCGCTGCTGACGG
CTACTTTGCGGTCCACAAG -> TACTTTGCGGTCCACAAGG
AACATCTTCGTATTGGTTG -> ACATCTTCGTATTGGTTGG
GTCACACCGGGCGGAGCGC -> TCACACCGGGCGGAGCGCA
AGTTGGCACAGCGGGGGCG -> GTTGGCACAGCGGGGGCGC
GGTATATACAACTTTGGGT -> GTATATACAACTTTGGGTG
TACGTAAGTCCAACCTCGG -> ACGTAAGTCCAACCTCGGC
TTTGTTTCGGTGGAAAGAC -> TTGTTTCGGTGGAAAGACT
TTATAACAAGCGGAGCAAA -> TATAACAAGCGGAGCAAAG
TCATCACACACCAGTCTTA -> CATCACACACCAGTCTTAC
CAGCGGAACATCTTCGTAT -> AGCGGAACATCTTCGTATT
GTTCCCATTTGATTTTGTT -> TTCCCATTTGATTTTGTTT
TCGCACAGGAGAACAACTC -> CGCACAGGAGAACAACTCG
GCTGGCTTGGCACCCAGTT -> CTGGCTTGGCACCCAGTTG
AAGCCTCGGTTCATTCCCT -> AGCCTCGGTTCATTCCCTA
ACCTCGAGTGGCCAGGTGT -> CCTCGAGTGGCCAGGTGTA
TTTCTCACCTTGTCACCAC -> TTCTCACCTTGTCACCACG
CGGAACGGGTGCACTCGCT -> GGAACGGGTGCACTCGCTA
GTTCTGACTAAGCCTTCCC -> TTCTGACTAAGCCTTCCCC
TTCCAGCCAGGGGTTGCTC -> TCCAGCCAGGGGTTGCTCT
GGTAGAGGACGATCTGGAT -> GTAGAGGACGATCTGGATG
ACAGACGCCGGAACGGGTG -> CAGACGCCGGAACGGGTGC
GGGCGGCCAGCAACCGGGG -> GGCGGCCAGCAACCGGGGC
GGCGCTCTTCTGCTCCAAA -> GCGCTCTTCTGCTCCAAAT
GATCCGCCAACCTCGAGTG -> ATCCGCCAACCTCGAGTGG
TTGTTTCTGCTGTTTCTCG -> TGTTTCTGCTGTTTCTCGG
GGAGTTGGAGGGTGGCGCT -> GAGTTGGAGGGTGGCGCTC
GAGGGTGGCGCTCACTGCC -> AGGGTGGCGCTCACTGCCG
ACAAATTCTCAGATTTAGT -> CAAATTCTCAGATTTAGTT
CGATTCGTCGCGATCACGA -> GATTCGTCGCGATCACGAG
CTACTCGGCCATACGTTAG -> TACTCGGCCATACGTTAGC
GTCACTGCTTCGATAAGGT -> TCACTGCTTCGATAAGGTT
CGCTGAATCAGTATTGTAG -> GCTGAATCAGTATTGTAGT
GCAACAGTTGGCACCTTTA -> CAACAGTTGGCACCTTTAA
GGGTTCATCGATACTGAAA -> GGTTCATCGATACTGAAAA
ACTTTCGATGTGGCTACTC -> CTTTCGATGTGGCTACTCA
GTGGATCTAGTCAAATCTA -> TGGATCTAGTCAAATCTAT
TTCTCAGATTTAGTTCGCG -> TCTCAGATTTAGTTCGCGA
CCTTCCCCGTCCCAGGCAA -> CTTCCCCGTCCCAGGCAAC
ATACTGAAAAGGCCTCTAG -> TACTGAAAAGGCCTCTAGG
GGGTAACTATCCGTACTGC -> GGTAACTATCCGTACTGCC
CTTGGCCAATAATTTTTGC -> TTGGCCAATAATTTTTGCC
AGACGCTCATATGAAAAGC -> GACGCTCATATGAAAAGCG
GACGGTGGCCGGTGTTAGC -> ACGGTGGCCGGTGTTAGCA
GGAGGTAGTGTTGGTGGAC -> GAGGTAGTGTTGGTGGACC
AAGCCTTCCCCGTCCCAGG -> AGCCTTCCCCGTCCCAGGC
GTACTATCGAGCACTCTAA -> TACTATCGAGCACTCTAAC
ATCAGACCTAGAGCTATGG -> TCAGACCTAGAGCTATGGG
CGCCGCAGTTCTTTAACTA -> GCCGCAGTTCTTTAACTAA
GCCGCTTTGTGTAGCAACA -> CCGCTTTGTGTAGCAACAG
CGAATCGGATTTTAAACCT -> GAATCGGATTTTAAACCTT
CACCTTGTCACCACGGACC -> ACCTTGTCACCACGGACCT
TGGTCATCGCCGCAGTTCT -> GGTCATCGCCGCAGTTCTT
TCGAGCACTCTAACACACA -> CGAGCACTCTAACACACAC
CGGAGACGATCGGAGTAAC -> GGAGACGATCGGAGTAACG
GCTCCAAATTGCTTCCAGC -> CTCCAAATTGCTTCCAGCC
TCTAGTGATGCCGGTACGC -> CTAGTGATGCCGGTACGCT
GACGATCTGGATGTGGGTC -> ACGATCTGGATGTGGGTCC
GATCGCTTCCACTCTGACA -> ATCGCTTCCACTCTGACAG
CCACTTGATCGTAAAGCCA -> CACTTGATCGTAAAGCCAC
TCGCGAACATCTCGCCTTT -> CGCGAACATCTCGCCTTTG
AGTGGGCAAGTGTCGCGAT -> GTGGGCAAGTGTCGCGATG
GTGTCCCGGTAGTGATTCT -> TGTCCCGGTAGTGATTCTA
TAGAGACCTTTCGCTACCT -> AGAGACCTTTCGCTACCTC
ACAATCGTCCAACAACATC -> CAATCGTCCAACAACATCA
CGGAGCGCAAGGTCTCCGT -> GGAGCGCAAGGTCTCCGTC
TGGAGGGTGGCGCTCACTG -> GGAGGGTGGCGCTCACTGC
GCCTTATAAAACCCTCTTC -> CCTTATAAAACCCTCTTCC
CAATATTTGTTTCGGTGGA -> AATATTTGTTTCGGTGGAA
AGTGGAGGTAGTGTTGGTG -> GTGGAGGTAGTGTTGGTGG
GCGTAACAAATTCTCAGAT -> CGTAACAAATTCTCAGATT
TTGGTGGACCAATCACGTG -> TGGTGGACCAATCACGTGA
ATTTTAAACCTTGAGTGGA -> TTTTAAACCTTGAGTGGAG
GGAGTGGGCAAGTGTCGCG -> GAGTGGGCAAGTGTCGCGA
CGCCAACCTCGAGTGGCCA -> GCCAACCTCGAGTGGCCAG
CCAGGCAACCTGGCGGTTG -> CAGGCAACCTGGCGGTTGG
AGTGTCGCGATGCCTTGAA -> GTGTCGCGATGCCTTGAAG
TCTTCGTATTGGTTGGTCA -> CTTCGTATTGGTTGGTCAT
CTCTGATGTGGGCTGTTTG -> TCTGATGTGGGCTGTTTGC
TCTCACCTTGTCACCACGG -> CTCACCTTGTCACCACGGA
GCTGAGGGCTGGGCCTTTT -> CTGAGGGCTGGGCCTTTTA
CGTGGATCTAGTCAAATCT -> GTGGATCTAGTCAAATCTA
TTCGATTTTTCTCACCTTG -> TCGATTTTTCTCACCTTGT
TTCGAATCGGATTTTAAAC -> TCGAATCGGATTTTAAACC
GGTACGCTTTCTGTAGCAA -> GTACGCTTTCTGTAGCAAC
AAAATCAGACCTAGAGCTA -> AAATCAGACCTAGAGCTAT
AACTTCATGTCATTACATT -> ACTTCATGTCATTACATTG
ATGATCCGCCAACCTCGAG -> TGATCCGCCAACCTCGAGT
CTCGGAACAGACGCCGGAA -> TCGGAACAGACGCCGGAAC
GTCCAACAACATCACCGGA -> TCCAACAACATCACCGGAG
TAGTTCTTCTGCTCCAAAT -> AGTTCTTCTGCTCCAAATT
AGGCTGATGATCCGCCAAC -> GGCTGATGATCCGCCAACC
GCGTGTGTATACAATCGTC -> CGTGTGTATACAATCGTCC
CCTTGTCTGGGCTCATCAT -> CTTGTCTGGGCTCATCATT
GTTAGCAACTGGACATCAA -> TTAGCAACTGGACATCAAC
GGGTGCGTACAATATCATG -> GGTGCGTACAATATCATGG
TTGGAGGGTGGCGCTCACT -> TGGAGGGTGGCGCTCACTG
GGGAACAGTAGATAATGAT -> GGAACAGTAGATAATGATC
CTCCAAATTGCTTAGTGCG -> TCCAAATTGCTTAGTGCGG
GCTTCGATAAGGTTCCATA -> CTTCGATAAGGTTCCATAC
CGAAACTATTAACCCGGTC -> GAAACTATTAACCCGGTCC
GCGATCACGAGCGGAGACG -> CGATCACGAGCGGAGACGA
CGGAACAGACGCCGGAACG -> GGAACAGACGCCGGAACGG
TGGCCGGTGTTAGCAATTC -> GGCCGGTGTTAGCAATTCC
CTTCCACTCTGACAGAGCC -> TTCCACTCTGACAGAGCCC
ACCGCTAACTTTCGGACGG -> CCGCTAACTTTCGGACGGC
GAACGGGTGCACTCGCTAG -> AACGGGTGCACTCGCTAGA
TATGTATATATTAGAAGAG -> ATGTATATATTAGAAGAGG
TGCTTAGTGCGGGCGGCCA -> GCTTAGTGCGGGCGGCCAG
AAAGGCCCCACTCTTCCGG -> AAGGCCCCACTCTTCCGGA
TCTCTGGGTTCATCGATAC -> CTCTGGGTTCATCGATACT
CCCCAAACTTCATGTCATT -> CCCAAACTTCATGTCATTA
TATCCGCTGCTGACGGTGG -> ATCCGCTGCTGACGGTGGC
AAGTCACACCGGGCGGAGC -> AGTCACACCGGGCGGAGCG
GATCTCTTGAGGGGTTCTC -> ATCTCTTGAGGGGTTCTCT
TTAAGGATGTAGCAACAGT -> TAAGGATGTAGCAACAGTT
TGATCGTAAAGCCACCAAC -> GATCGTAAAGCCACCAACT
CTTCCCCGTCCCAGGCAAC -> TTCCCCGTCCCAGGCAACC
GATAGACGCTCATATGAAA -> ATAGACGCTCATATGAAAA
GGACGATCTGGATGTGGGT -> GACGATCTGGATGTGGGTC
ACACACACCGCAACAAACG -> CACACACCGCAACAAACGC
ATGTAGCAACAGTTGGCAC -> TGTAGCAACAGTTGGCACA
ACCTAGAGCTATGGGGTTA -> CCTAGAGCTATGGGGTTAC
GCCCGTTTTACCCAACGAG -> CCCGTTTTACCCAACGAGC
AATATTTGTTTCGGTGGAA -> ATATTTGTTTCGGTGGAAA
GTGTTGGTGGACCAATCAC -> TGTTGGTGGACCAATCACG
ATCCACACTTTCGATGTGG -> TCCACACTTTCGATGTGGC
AACCGTCACCGAGCACCCC -> ACCGTCACCGAGCACCCCA
GTGAATCTAGTCCGCCTTG -> TGAATCTAGTCCGCCTTGT
CCAAATTGCTGACTGTTAG -> CAAATTGCTGACTGTTAGA
TCGGAACAGACGCCGGAAC -> CGGAACAGACGCCGGAACG
GCCGGTACGCTTTCTGTAG -> CCGGTACGCTTTCTGTAGC
AAGTCCAACCTCGGCTCTG -> AGTCCAACCTCGGCTCTGA
GCTGAAATGTAGACGAAAC -> CTGAAATGTAGACGAAACT
TTCCACTCTGACAGAGCCC -> TCCACTCTGACAGAGCCCG
TCCGTCATATGACAATATT -> CCGTCATATGACAATATTT
CGGGTAACTATCCGTACTG -> GGGTAACTATCCGTACTGC
CCAACAACATCACCGGAGT -> CAACAACATCACCGGAGTT
TTTTTCTCACCTTGTCACC -> TTTTCTCACCTTGTCACCA
TGTTTGCTCCGGAGTGGGC -> GTTTGCTCCGGAGTGGGCA
GTGGGCTGTTTGCTCCGGA -> TGGGCTGTTTGCTCCGGAG
CGCTGGTGTTCGAATCGGA -> GCTGGTGTTCGAATCGGAT
CATTAGGCATTCGATTTTT -> ATTAGGCATTCGATTTTTC
GAGACGATCGGAGTAACGA -> AGACGATCGGAGTAACGAA
GTAACTATCCGTACTGCCG -> TAACTATCCGTACTGCCGA
GTAGTATGCTGCCGGCCCT -> TAGTATGCTGCCGGCCCTC
ACTTGATCGTAAAGCCACC -> CTTGATCGTAAAGCCACCA
TGATGCCGGTACGCTTTCT -> GATGCCGGTACGCTTTCTG
ATCACGGTAGGGTACTATC -> TCACGGTAGGGTACTATCG
CACTGCTTCGATAAGGTTC -> ACTGCTTCGATAAGGTTCC
TAGTCTCGTTTTGGTCCCC -> AGTCTCGTTTTGGTCCCCC
TTAAGTCACACCGGGCGGA -> TAAGTCACACCGGGCGGAG
CAGTCTTACAGCGCCATGA -> AGTCTTACAGCGCCATGAC
CCATTAGGCGCCAAAGGCC -> CATTAGGCGCCAAAGGCCC
ACACACCAGTCTTACAGCG -> CACACCAGTCTTACAGCGC
GCCGTGATTCTGACATCAA -> CCGTGATTCTGACATCAAT
GATGTAGCAACAGTTGGCA -> ATGTAGCAACAGTTGGCAC
ATCGATTGGGTCGTTAAGC -> TCGATTGGGTCGTTAAGCC
TGGACGTGTTGGCGATTGA -> GGACGTGTTGGCGATTGAC
CGGCCAGCAACCGGGGCGG -> GGCCAGCAACCGGGGCGGA
GGCACTGGATGCGTGGTCT -> GCACTGGATGCGTGGTCTT
ATTTGATTTTGTTTCTGCT -> TTTGATTTTGTTTCTGCTG
GAGTGGCCAGGTGTACGTA -> AGTGGCCAGGTGTACGTAA
CGCCGGTAAACTAGTCTCG -> GCCGGTAAACTAGTCTCGT
CAGTTGGCACCTTTAATAA -> AGTTGGCACCTTTAATAAT
TCCTTGTAGCAACAGTTGG -> CCTTGTAGCAACAGTTGGC
ACGGACCTGATCGCACAGG -> CGGACCTGATCGCACAGGA
GGAGCAAAGCAGAAATTTG -> GAGCAAAGCAGAAATTTGC
TGGTGAATCTAGTCCGCCT -> GGTGAATCTAGTCCGCCTT
AGTTCTTCTGCTCCAAATT -> GTTCTTCTGCTCCAAATTG
GGTCATCGCCGCAGTTCTT -> GTCATCGCCGCAGTTCTTT
CGCGATCACGAGCGGAGAC -> GCGATCACGAGCGGAGACG
ATCCTTGTAGCAACAGTTG -> TCCTTGTAGCAACAGTTGG
AGCGCCATGACGGTAGAGG -> GCGCCATGACGGTAGAGGA
ATCGGAGTAACGAAGATCG -> TCGGAGTAACGAAGATCGC
TCCGTATGTATATATTAGA -> CCGTATGTATATATTAGAA
GAGTTGGAGGGTGGCGCTC -> AGTTGGAGGGTGGCGCTCA
CACCTTCAACTTCTGGGGA -> ACCTTCAACTTCTGGGGAA
GTTCTTTAACTAAAATCGA -> TTCTTTAACTAAAATCGAA
GGTCGTTAAGCCCCCATTA -> GTCGTTAAGCCCCCATTAC
TTCTGCTCCAAATTGCTGA -> TCTGCTCCAAATTGCTGAC
GTAGCAACAGTTGGCACAG -> TAGCAACAGTTGGCACAGC
GGGGTTGCTCTTGTATAAG -> GGGTTGCTCTTGTATAAGG
TCACCGAGCACCCCAAACT -> CACCGAGCACCCCAAACTT
CCGATGTGCGGTGATCTGG -> CGATGTGCGGTGATCTGGG
GAGCCGCTTTGTGTAGCAA -> AGCCGCTTTGTGTAGCAAC
ACCGTCACCGAGCACCCCA -> CCGTCACCGAGCACCCCAA
GTGGTCTTCTGCTCCAAAT -> TGGTCTTCTGCTCCAAATT
CAACAAATATCCGCTGCTG -> AACAAATATCCGCTGCTGA
GACGGTAGAGGACGATCTG -> ACGGTAGAGGACGATCTGG
CCAACGAGCGCAGCGGAAC -> CAACGAGCGCAGCGGAACA
GGCTACTCATCGCTGGTGT -> GCTACTCATCGCTGGTGTT
TATAAGGTCACTGCTTCGA -> ATAAGGTCACTGCTTCGAT
GCTGCTGACGGTGGCCGGT -> CTGCTGACGGTGGCCGGTG
TGCTCCGGAGTGGGCAAGT -> GCTCCGGAGTGGGCAAGTG
CTTTAACTAAAATCGAAAC -> TTTAACTAAAATCGAAACT
ACTAAGCCTTCCCCGTCCC -> CTAAGCCTTCCCCGTCCCA
GCTGTTTGCTCCGGAGTGG -> CTGTTTGCTCCGGAGTGGG
GCGTCGGGTAACTATCCGT -> CGTCGGGTAACTATCCGTA
GGAGTAACGAAGATCGCGT -> GAGTAACGAAGATCGCGTA
AAATGTAGACGAAACTATT -> AATGTAGACGAAACTATTA
ATTGGGTCGTTAAGCCCCC -> TTGGGTCGTTAAGCCCCCA
AGATCGCGTAACAAATTCT -> GATCGCGTAACAAATTCTC
TAGCAACAGTTGGCACTGG -> AGCAACAGTTGGCACTGGA
AACGCCGTGATTCTGACAT -> ACGCCGTGATTCTGACATC
TACGTTGGGCTATCTTATA -> ACGTTGGGCTATCTTATAA
CGCTCTTCTGCTCCAAATT -> GCTCTTCTGCTCCAAATTG
TCCAACAACATCACCGGAG -> CCAACAACATCACCGGAGT
ATTGCTGACTGTTAGAGCC -> TTGCTGACTGTTAGAGCCG
TCGGCTCTGATGTGGGCTG -> CGGCTCTGATGTGGGCTGT
AACCTCGAGTGGCCAGGTG -> ACCTCGAGTGGCCAGGTGT
CGGCTCTGATGTGGGCTGT -> GGCTCTGATGTGGGCTGTT
AGCAATTCCGTATGTATAT -> GCAATTCCGTATGTATATA
CCGAGTTATACTCGTTTCC -> CGAGTTATACTCGTTTCCC
TTGAGTGGAGGTAGTGTTG -> TGAGTGGAGGTAGTGTTGG
GGTGTCTCGGAGCTAACTG -> GTGTCTCGGAGCTAACTGA
TTCTTTAACTAAAATCGAA -> TCTTTAACTAAAATCGAAA
AATTCTCAGATTTAGTTCG -> ATTCTCAGATTTAGTTCGC
TAAAACCCTCTTCCCGTAT -> AAAACCCTCTTCCCGTATT
AGCGGAGCAAAGCAGAAAT -> GCGGAGCAAAGCAGAAATT
GTTAAGCCCCCATTACGAT -> TTAAGCCCCCATTACGATC
CGCAGGATCGCTTCCACTC -> GCAGGATCGCTTCCACTCT
GGGTGTTCCCATTTGATTT -> GGTGTTCCCATTTGATTTT
GTCTCGTTTTGGTCCCCCC -> TCTCGTTTTGGTCCCCCCG
TAGTGATGCCGGTACGCTT -> AGTGATGCCGGTACGCTTT
TAGACGCTCATATGAAAAG -> AGACGCTCATATGAAAAGC
GTAAACTAGTCTCGTTTTG -> TAAACTAGTCTCGTTTTGG
ACAGCTAAGGGTGTTCCCA -> CAGCTAAGGGTGTTCCCAT
TGATTCTACTTTGCGGTCC -> GATTCTACTTTGCGGTCCA
GCTCCAAATTGCTTAAGTC -> CTCCAAATTGCTTAAGTCA
CCCAGGCAACCTGGCGGTT -> CCAGGCAACCTGGCGGTTG
AGAGGACGATCTGGATGTG -> GAGGACGATCTGGATGTGG
GTGGAAAGACTCAGTAGTA -> TGGAAAGACTCAGTAGTAT
TACTCGTTTCCCACTTGAT -> ACTCGTTTCCCACTTGATC
ACAACATCACCGGAGTTCT -> CAACATCACCGGAGTTCTG
GAGAACAACTCGGAACAGA -> AGAACAACTCGGAACAGAC
CTGTGTCCCGGTAGTGATT -> TGTGTCCCGGTAGTGATTC
TGAAATGTAGACGAAACTA -> GAAATGTAGACGAAACTAT
GATTTTAAACCTTGAGTGG -> ATTTTAAACCTTGAGTGGA
TGCTGACTGTTAGAGCCGC -> GCTGACTGTTAGAGCCGCT
GTGATCTTCGGTGACAGTT -> TGATCTTCGGTGACAGTTC
TGTAGTAGAGGGAGCTGAG -> GTAGTAGAGGGAGCTGAGG
CTACGCCGCCGGTAAACTA -> TACGCCGCCGGTAAACTAG
TGTCATTACATTGGACGTG -> GTCATTACATTGGACGTGT
CTCACTGCCGATTCGTCGC -> TCACTGCCGATTCGTCGCG
CACTCTGACAGAGCCCGTT -> ACTCTGACAGAGCCCGTTT
TAGTAGAGGGAGCTGAGGG -> AGTAGAGGGAGCTGAGGGC
AACCTGGCGGTTGGTGTCG -> ACCTGGCGGTTGGTGTCGT
ATTCCCTATTCCGCATCGA -> TTCCCTATTCCGCATCGAT
GCAGGATCGCTTCCACTCT -> CAGGATCGCTTCCACTCTG
GGTCACTGCTTCGATAAGG -> GTCACTGCTTCGATAAGGT
AACTTCTGGGGAACAGTAG -> ACTTCTGGGGAACAGTAGA
GCATTCGATTTTTCTCACC -> CATTCGATTTTTCTCACCT
TAGTGATTCTACTTTGCGG -> AGTGATTCTACTTTGCGGT
GATCTAGTCAAATCTATCC -> ATCTAGTCAAATCTATCCA
