CCTTTCCCGGAGCCCGTGCG -> CTTTCCCGGAGCCCGTGCGG
TCCCATCCGCGCCGACGTGT -> CCCATCCGCGCCGACGTGTC
CAACACCCGTACTCAAATCT -> AACACCCGTACTCAAATCTA
TCCCGAGACTCTAGAGATAA -> CCCGAGACTCTAGAGATAAC
TGTTCGTTGCCCATAAACTC -> GTTCGTTGCCCATAAACTCG
GAAGCATGAAGGAAGTAGGC -> AAGCATGAAGGAAGTAGGCG
GATGATCTTGCGGTCTTGCC -> ATGATCTTGCGGTCTTGCCT
TGCTATTACCTACAACTCCC -> GCTATTACCTACAACTCCCA
CTCGCGACACCAGGCTGATA -> TCGCGACACCAGGCTGATAC
TGTGCCCATGTCGTGGACTG -> GTGCCCATGTCGTGGACTGT
CCGTACTCAAATCTATCAAT -> CGTACTCAAATCTATCAATT
CGATCCGAGGTTTAGCGTAC -> GATCCGAGGTTTAGCGTACA
AGGCGGTCACTTAATAGCTA -> GGCGGTCACTTAATAGCTAT
TGTGTACGATCCGAGGTTTA -> GTGTACGATCCGAGGTTTAG
TTACACGGGTGTGCCTCGGC -> TACACGGGTGTGCCTCGGCA
ATTCGATTCCATGCATTGTC -> TTCGATTCCATGCATTGTCC
TAATAGCTATAGTATCGACG -> AATAGCTATAGTATCGACGG
ACATAAGGCCGAACAGCCAT -> CATAAGGCCGAACAGCCATT
AAGTATTCCTTAGACTCCCG -> AGTATTCCTTAGACTCCCGA
GACACAAGAGGGGTGTGATC -> ACACAAGAGGGGTGTGATCT
TGACGCCAGACACAAGAGGG -> GACGCCAGACACAAGAGGGG
CGTACTCAAATCTATCAATT -> GTACTCAAATCTATCAATTC
GCTCGCGACACCAGGCTGAT -> CTCGCGACACCAGGCTGATA
CGCGCCGACGTGTCATGTAC -> GCGCCGACGTGTCATGTACC
ACGCTTCGTAAACAGCTGTG -> CGCTTCGTAAACAGCTGTGT
CCAGGTTACGAATGCTATTA -> CAGGTTACGAATGCTATTAC
GCTGATGATCTTGCGGTCTT -> CTGATGATCTTGCGGTCTTG
AGGCCACATGCCAGCCGGCA -> GGCCACATGCCAGCCGGCAG
CAAGTAGTGAGTTACACGGG -> AAGTAGTGAGTTACACGGGT
TTGGATGTGGAGTAACATAA -> TGGATGTGGAGTAACATAAG
ATCATGAAAATGACTTCGTA -> TCATGAAAATGACTTCGTAT
CCGAGACTCTAGAGATAACG -> CGAGACTCTAGAGATAACGT
TCGTGTAGTCTCATGCTCGC -> CGTGTAGTCTCATGCTCGCG
ATACGTCACATGTGCCCATG -> TACGTCACATGTGCCCATGT
CCTCCGCTTTCCGGCCATGT -> CTCCGCTTTCCGGCCATGTC
GGACTGTCTGAGGGAATGTC -> GACTGTCTGAGGGAATGTCC
CCCTACGCTTCGTAAACAGC -> CCTACGCTTCGTAAACAGCT
CCTAAGGCAAGTAGTGAGTT -> CTAAGGCAAGTAGTGAGTTA
TCCGCGCCGACGTGTCATGT -> CCGCGCCGACGTGTCATGTA
TCCTGCGTACGCCGCCGGCG -> CCTGCGTACGCCGCCGGCGG
ACTGATATCATGAAAATGAC -> CTGATATCATGAAAATGACT
ATAAACTCGCGCACCCGTCG -> TAAACTCGCGCACCCGTCGA
TACCTCAGCACTCAACGGCA -> ACCTCAGCACTCAACGGCAT
GCTTCGTAAACAGCTGTGTC -> CTTCGTAAACAGCTGTGTCC
CCGCCGGCGGGGGTCCAGTG -> CGCCGGCGGGGGTCCAGTGG
TGAGTGTTCATAGGTAAATG -> GAGTGTTCATAGGTAAATGG
CGCCAGACACAAGAGGGGTG -> GCCAGACACAAGAGGGGTGT
TGCCTCGGCATGAACGGACC -> GCCTCGGCATGAACGGACCA
ACTCCCACGTAAATGTGTAC -> CTCCCACGTAAATGTGTACG
TTAGGGTGTTGACGCCAGAC -> TAGGGTGTTGACGCCAGACA
TATGAGTGTTCATAGGTAAA -> ATGAGTGTTCATAGGTAAAT
CCATGCATTGTCCTTTCCCG -> CATGCATTGTCCTTTCCCGG
GCCTCAGACTCCCAGATAAT -> CCTCAGACTCCCAGATAATG
ATGCTATTACCTACAACTCC -> TGCTATTACCTACAACTCCC
TGAGTTACACGGGTGTGCCT -> GAGTTACACGGGTGTGCCTC
GTGCGGAAGTATTCCTTAGA -> TGCGGAAGTATTCCTTAGAC
CTATAGTATCGACGGCTTAT -> TATAGTATCGACGGCTTATG
CGACACCAGGCTGATACTAA -> GACACCAGGCTGATACTAAG
CCTACAACTCCCACGTAAAT -> CTACAACTCCCACGTAAATG
CTGATACTAAGGCCACATGC -> TGATACTAAGGCCACATGCC
ACTCCCGAGACTCTAGAGAT -> CTCCCGAGACTCTAGAGATA
CTGTAATGATCAGCAGACAA -> TGTAATGATCAGCAGACAAC
CGCTTCGTAAACAGCTGTGT -> GCTTCGTAAACAGCTGTGTC
CGTAAACAGCTGTGTCCTCC -> GTAAACAGCTGTGTCCTCCG
GACTCCCGAGACTCTAGAGA -> ACTCCCGAGACTCTAGAGAT
TTGCAATACGTCACATGTGC -> TGCAATACGTCACATGTGCC
AGCGCCACCTTCAACACCCG -> GCGCCACCTTCAACACCCGT
GCCCGTGCGGAAGTATTCCT -> CCCGTGCGGAAGTATTCCTT
ATGATCAGCAGACAACTGAG -> TGATCAGCAGACAACTGAGA
CACCAGGCTGATACTAAGGC -> ACCAGGCTGATACTAAGGCC
ACTCCCAGATAATGAAACGA -> CTCCCAGATAATGAAACGAG
TTCCCTCTCACGGGTTTGAT -> TCCCTCTCACGGGTTTGATT
TGAACGGACCACTCCCATGT -> GAACGGACCACTCCCATGTT
ACAGCCATTCCTGCGTACGC -> CAGCCATTCCTGCGTACGCC
GGTTGGACCCTGGGTTTAAG -> GTTGGACCCTGGGTTTAAGC
TAACATAAGGCCGAACAGCC -> AACATAAGGCCGAACAGCCA
CACCTTCAACACCCGTACTC -> ACCTTCAACACCCGTACTCA
TACACGGGTGTGCCTCGGCA -> ACACGGGTGTGCCTCGGCAT
TATTTCCCTCTCACGGGTTT -> ATTTCCCTCTCACGGGTTTG
CGTGGACTGTCTGAGGGAAT -> GTGGACTGTCTGAGGGAATG
TTGGTCCCTACGCTTCGTAA -> TGGTCCCTACGCTTCGTAAA
GTGATCTTGGATGTGGAGTA -> TGATCTTGGATGTGGAGTAA
GGGGGAGGTCTAAGGTATGA -> GGGGAGGTCTAAGGTATGAG
CCTCTCACGGGTTTGATTAG -> CTCTCACGGGTTTGATTAGG
ATCAGCAGACAACTGAGACT -> TCAGCAGACAACTGAGACTA
CTATTTCCCTCTCACGGGTT -> TATTTCCCTCTCACGGGTTT
TAAATGTGTACGATCCGAGG -> AAATGTGTACGATCCGAGGT
ACTACCGCCCCGCGCCACAT -> CTACCGCCCCGCGCCACATC
ATGTGTACGATCCGAGGTTT -> TGTGTACGATCCGAGGTTTA
GACAACTGAGACTATTTCCC -> ACAACTGAGACTATTTCCCT
CCAGCCGGCAGACAAGTACA -> CAGCCGGCAGACAAGTACAT
ATGTTGACTACCGCCCCGCG -> TGTTGACTACCGCCCCGCGC
GCACTCAACGGCATGGCTGA -> CACTCAACGGCATGGCTGAT
TATTCCTTAGACTCCCGAGA -> ATTCCTTAGACTCCCGAGAC
GTATTCGTGTAGTCTCATGC -> TATTCGTGTAGTCTCATGCT
CGCGCCACATCAGGATCCAC -> GCGCCACATCAGGATCCACT
GACCCTGGGTTTAAGCGCCA -> ACCCTGGGTTTAAGCGCCAC
TGAAAATGACTTCGTATTCG -> GAAAATGACTTCGTATTCGT
GCGGCGAGTAACTCGAGATT -> CGGCGAGTAACTCGAGATTC
ATATCATGAAAATGACTTCG -> TATCATGAAAATGACTTCGT
TCGTTGCCCATAAACTCGCG -> CGTTGCCCATAAACTCGCGC
CTTTCCGGCCATGTCAAGGG -> TTTCCGGCCATGTCAAGGGG
TCAATGACCATTCGATTCCA -> CAATGACCATTCGATTCCAT
ACCCTGGGTTTAAGCGCCAC -> CCCTGGGTTTAAGCGCCACC
GGTACTGATATCATGAAAAT -> GTACTGATATCATGAAAATG
CTAAACACCCGTTTGGTCCC -> TAAACACCCGTTTGGTCCCT
GGAGGTCTAAGGTATGAGTG -> GAGGTCTAAGGTATGAGTGT
ACTCGAGATTCCTCGGAAGC -> CTCGAGATTCCTCGGAAGCA
ACACACCTAAGGCAAGTAGT -> CACACCTAAGGCAAGTAGTG
TTCCCGGAGCCCGTGCGGAA -> TCCCGGAGCCCGTGCGGAAG
TAATTATGCCAGGTTTGCAA -> AATTATGCCAGGTTTGCAAT
CATGCATTGTCCTTTCCCGG -> ATGCATTGTCCTTTCCCGGA
ATAACGTGCTGGCGGCGAGT -> TAACGTGCTGGCGGCGAGTA
CGTCCCATCCGCGCCGACGT -> GTCCCATCCGCGCCGACGTG
CCTTCAACACCCGTACTCAA -> CTTCAACACCCGTACTCAAA
ATTGTCATCAATGACCATTC -> TTGTCATCAATGACCATTCG
ATGATCTTGCGGTCTTGCCT -> TGATCTTGCGGTCTTGCCTC
TTTCGATTGTCATCAATGAC -> TTCGATTGTCATCAATGACC
GCGCCACATCAGGATCCACT -> CGCCACATCAGGATCCACTC
GGTTTCGATTGTCATCAATG -> GTTTCGATTGTCATCAATGA
TGCAATACGTCACATGTGCC -> GCAATACGTCACATGTGCCC
TGGCTGATGATCTTGCGGTC -> GGCTGATGATCTTGCGGTCT
CTTCGTATTCGTGTAGTCTC -> TTCGTATTCGTGTAGTCTCA
CGTACACACCTAAGGCAAGT -> GTACACACCTAAGGCAAGTA
AAGGGGGAGGTCTAAGGTAT -> AGGGGGAGGTCTAAGGTATG
GTCTGAGGGAATGTCCAGGT -> TCTGAGGGAATGTCCAGGTT
CATTGTCCTTTCCCGGAGCC -> ATTGTCCTTTCCCGGAGCCC
CCACATCAGGATCCACTCCA -> CACATCAGGATCCACTCCAC
ACCCGTACTCAAATCTATCA -> CCCGTACTCAAATCTATCAA
AGTAGTGAGTTACACGGGTG -> GTAGTGAGTTACACGGGTGT
GCCATGTCAAGGGGGAGGTC -> CCATGTCAAGGGGGAGGTCT
GCCATTCCTGCGTACGCCGC -> CCATTCCTGCGTACGCCGCC
TCCTCGGAAGCATGAAGGAA -> CCTCGGAAGCATGAAGGAAG
GATCTTGCGGTCTTGCCTCA -> ATCTTGCGGTCTTGCCTCAG
AATGATCAGCAGACAACTGA -> ATGATCAGCAGACAACTGAG
AGCGTACACACCTAAGGCAA -> GCGTACACACCTAAGGCAAG
CGAGACTCTAGAGATAACGT -> GAGACTCTAGAGATAACGTG
TTCCTGCGTACGCCGCCGGC -> TCCTGCGTACGCCGCCGGCG
CGGCATGAACGGACCACTCC -> GGCATGAACGGACCACTCCC
CCATTCCTGCGTACGCCGCC -> CATTCCTGCGTACGCCGCCG
GGGGTCCAGTGGTTTCGATT -> GGGTCCAGTGGTTTCGATTG
ACGGGTTTGATTAGGGTGTT -> CGGGTTTGATTAGGGTGTTG
GGCGGGGGTCCAGTGGTTTC -> GCGGGGGTCCAGTGGTTTCG
TCGAGAGAACCTGTAATGAT -> CGAGAGAACCTGTAATGATC
CATAGGTAAATGGTGAGTCT -> ATAGGTAAATGGTGAGTCTG
AAGCATGAAGGAAGTAGGCG -> AGCATGAAGGAAGTAGGCGG
GAAGGAAGTAGGCGGTCACT -> AAGGAAGTAGGCGGTCACTT
ATGCCAGGTTTGCAATACGT -> TGCCAGGTTTGCAATACGTC
AATAGCTATAGTATCGACGG -> ATAGCTATAGTATCGACGGC
GGAAGCATGAAGGAAGTAGG -> GAAGCATGAAGGAAGTAGGC
TAAGGCAAGTAGTGAGTTAC -> AAGGCAAGTAGTGAGTTACA
GGACCCTGGGTTTAAGCGCC -> GACCCTGGGTTTAAGCGCCA
CCCATAAACTCGCGCACCCG -> CCATAAACTCGCGCACCCGT
CTTGCCTCAGACTCCCAGAT -> TTGCCTCAGACTCCCAGATA
TCGGCATGAACGGACCACTC -> CGGCATGAACGGACCACTCC
AGAGGGGTGTGATCTTGGAT -> GAGGGGTGTGATCTTGGATG
AGACAAGTACATGACACGTT -> GACAAGTACATGACACGTTC
GACTATTTCCCTCTCACGGG -> ACTATTTCCCTCTCACGGGT
TCCTTTCCCGGAGCCCGTGC -> CCTTTCCCGGAGCCCGTGCG
GGCCACATGCCAGCCGGCAG -> GCCACATGCCAGCCGGCAGA
AGTGTTCATAGGTAAATGGT -> GTGTTCATAGGTAAATGGTG
TTTGGTCCCTACGCTTCGTA -> TTGGTCCCTACGCTTCGTAA
ACACCCGTACTCAAATCTAT -> CACCCGTACTCAAATCTATC
GTCTTGCCTCAGACTCCCAG -> TCTTGCCTCAGACTCCCAGA
ACCTACAACTCCCACGTAAA -> CCTACAACTCCCACGTAAAT
ATGTCAAGGGGGAGGTCTAA -> TGTCAAGGGGGAGGTCTAAG
AACAGCCATTCCTGCGTACG -> ACAGCCATTCCTGCGTACGC
AAACACCCGTTTGGTCCCTA -> AACACCCGTTTGGTCCCTAC
TACGTCACATGTGCCCATGT -> ACGTCACATGTGCCCATGTC
AGCCCGTGCGGAAGTATTCC -> GCCCGTGCGGAAGTATTCCT
ATGCATTGTCCTTTCCCGGA -> TGCATTGTCCTTTCCCGGAG
CACGGGTTTGATTAGGGTGT -> ACGGGTTTGATTAGGGTGTT
CACCTAAGGCAAGTAGTGAG -> ACCTAAGGCAAGTAGTGAGT
GCGGTCACTTAATAGCTATA -> CGGTCACTTAATAGCTATAG
ATGAAAATGACTTCGTATTC -> TGAAAATGACTTCGTATTCG
CTTGGATGTGGAGTAACATA -> TTGGATGTGGAGTAACATAA
GTTCGATCGTCCCATCCGCG -> TTCGATCGTCCCATCCGCGC
TGTCTGAGGGAATGTCCAGG -> GTCTGAGGGAATGTCCAGGT
CTTAGACTCCCGAGACTCTA -> TTAGACTCCCGAGACTCTAG
GGCCATGTCAAGGGGGAGGT -> GCCATGTCAAGGGGGAGGTC
CACTTAATAGCTATAGTATC -> ACTTAATAGCTATAGTATCG
GGCGAGTAACTCGAGATTCC -> GCGAGTAACTCGAGATTCCT
ACATGCCAGCCGGCAGACAA -> CATGCCAGCCGGCAGACAAG
TGGACCCTGGGTTTAAGCGC -> GGACCCTGGGTTTAAGCGCC
CGTTGCCCATAAACTCGCGC -> GTTGCCCATAAACTCGCGCA
TTCGATTCCATGCATTGTCC -> TCGATTCCATGCATTGTCCT
CGGCGAGTAACTCGAGATTC -> GGCGAGTAACTCGAGATTCC
CATAAGGCCGAACAGCCATT -> ATAAGGCCGAACAGCCATTC
GATACTAAGGCCACATGCCA -> ATACTAAGGCCACATGCCAG
TCCAGTGGTTTCGATTGTCA -> CCAGTGGTTTCGATTGTCAT
AGGATCCACTCCACAGGGTT -> GGATCCACTCCACAGGGTTA
TGTTGACGCCAGACACAAGA -> GTTGACGCCAGACACAAGAG
TTAGCGTACACACCTAAGGC -> TAGCGTACACACCTAAGGCA
GAGACTATTTCCCTCTCACG -> AGACTATTTCCCTCTCACGG
GTCCTCCGCTTTCCGGCCAT -> TCCTCCGCTTTCCGGCCATG
TAATGATCAGCAGACAACTG -> AATGATCAGCAGACAACTGA
CGCCGACGTGTCATGTACCA -> GCCGACGTGTCATGTACCAG
ACCAGGTTACGAATGCTATT -> CCAGGTTACGAATGCTATTA
CCATGTTGACTACCGCCCCG -> CATGTTGACTACCGCCCCGC
CAGGCTGATACTAAGGCCAC -> AGGCTGATACTAAGGCCACA
AGACAACTGAGACTATTTCC -> GACAACTGAGACTATTTCCC
TGCCAGGTTTGCAATACGTC -> GCCAGGTTTGCAATACGTCA
GGCTGATACTAAGGCCACAT -> GCTGATACTAAGGCCACATG
GACTTCGTATTCGTGTAGTC -> ACTTCGTATTCGTGTAGTCT
ACGGGTGTGCCTCGGCATGA -> CGGGTGTGCCTCGGCATGAA
CCTCAGACTCCCAGATAATG -> CTCAGACTCCCAGATAATGA
CTCATGCTCGCGACACCAGG -> TCATGCTCGCGACACCAGGC
TAGCTATAGTATCGACGGCT -> AGCTATAGTATCGACGGCTT
CCGAACAGCCATTCCTGCGT -> CGAACAGCCATTCCTGCGTA
TAAGCGCCACCTTCAACACC -> AAGCGCCACCTTCAACACCC
ACATGTGCCCATGTCGTGGA -> CATGTGCCCATGTCGTGGAC
GAGATTCCTCGGAAGCATGA -> AGATTCCTCGGAAGCATGAA
ATCAATTCGGTACTGATATC -> TCAATTCGGTACTGATATCA
CTTTCCCGGAGCCCGTGCGG -> TTTCCCGGAGCCCGTGCGGA
CAGCAGACAACTGAGACTAT -> AGCAGACAACTGAGACTATT
GTGCTGGCGGCGAGTAACTC -> TGCTGGCGGCGAGTAACTCG
CGCGACACCAGGCTGATACT -> GCGACACCAGGCTGATACTA
GCGTACGCCGCCGGCGGGGG -> CGTACGCCGCCGGCGGGGGT
CGTTTGGTCCCTACGCTTCG -> GTTTGGTCCCTACGCTTCGT
CACGTTCGATCGTCCCATCC -> ACGTTCGATCGTCCCATCCG
ACACAAGAGGGGTGTGATCT -> CACAAGAGGGGTGTGATCTT
CTCCCACGTAAATGTGTACG -> TCCCACGTAAATGTGTACGA
CTATTACCTACAACTCCCAC -> TATTACCTACAACTCCCACG
GGTCACTTAATAGCTATAGT -> GTCACTTAATAGCTATAGTA
TATTCGTGTAGTCTCATGCT -> ATTCGTGTAGTCTCATGCTC
AACTCCCACGTAAATGTGTA -> ACTCCCACGTAAATGTGTAC
TGTGATCTTGGATGTGGAGT -> GTGATCTTGGATGTGGAGTA
TTGGACCCTGGGTTTAAGCG -> TGGACCCTGGGTTTAAGCGC
GTAATTATGCCAGGTTTGCA -> TAATTATGCCAGGTTTGCAA
TGTACGATCCGAGGTTTAGC -> GTACGATCCGAGGTTTAGCG
GTATTCCTTAGACTCCCGAG -> TATTCCTTAGACTCCCGAGA
CGTGCTGGCGGCGAGTAACT -> GTGCTGGCGGCGAGTAACTC
CTACCGCCCCGCGCCACATC -> TACCGCCCCGCGCCACATCA
TCTAAGGTATGAGTGTTCAT -> CTAAGGTATGAGTGTTCATA
ACCAGGCTGATACTAAGGCC -> CCAGGCTGATACTAAGGCCA
GTGTTCATAGGTAAATGGTG -> TGTTCATAGGTAAATGGTGA
CTACCTCAGCACTCAACGGC -> TACCTCAGCACTCAACGGCA
CCAGATAATGAAACGAGAGG -> CAGATAATGAAACGAGAGGC
TTTCCCGGAGCCCGTGCGGA -> TTCCCGGAGCCCGTGCGGAA
AGCTATAGTATCGACGGCTT -> GCTATAGTATCGACGGCTTA
GGTTTAAGCGCCACCTTCAA -> GTTTAAGCGCCACCTTCAAC
CTTGCGGTCTTGCCTCAGAC -> TTGCGGTCTTGCCTCAGACT
GGGGTGTGATCTTGGATGTG -> GGGTGTGATCTTGGATGTGG
TTAGACTCCCGAGACTCTAG -> TAGACTCCCGAGACTCTAGA
GCGTAATTATGCCAGGTTTG -> CGTAATTATGCCAGGTTTGC
GTCTAAGGTATGAGTGTTCA -> TCTAAGGTATGAGTGTTCAT
GCATGAACGGACCACTCCCA -> CATGAACGGACCACTCCCAT
GTGGTTTCGATTGTCATCAA -> TGGTTTCGATTGTCATCAAT
CTACAACTCCCACGTAAATG -> TACAACTCCCACGTAAATGT
TGCCTCAGACTCCCAGATAA -> GCCTCAGACTCCCAGATAAT
TCAGGATCCACTCCACAGGG -> CAGGATCCACTCCACAGGGT
GTTACGAATGCTATTACCTA -> TTACGAATGCTATTACCTAC
GACTACCGCCCCGCGCCACA -> ACTACCGCCCCGCGCCACAT
TGTCGTGGACTGTCTGAGGG -> GTCGTGGACTGTCTGAGGGA
CCTCGGAAGCATGAAGGAAG -> CTCGGAAGCATGAAGGAAGT
AGGTTGGACCCTGGGTTTAA -> GGTTGGACCCTGGGTTTAAG
ACCTTCAACACCCGTACTCA -> CCTTCAACACCCGTACTCAA
TGTGCCTCGGCATGAACGGA -> GTGCCTCGGCATGAACGGAC
TACATGACACGTTCGATCGT -> ACATGACACGTTCGATCGTC
TCCTTAGACTCCCGAGACTC -> CCTTAGACTCCCGAGACTCT
AGAACCTGTAATGATCAGCA -> GAACCTGTAATGATCAGCAG
AGGTTTAGCGTACACACCTA -> GGTTTAGCGTACACACCTAA
GCAAGTAGTGAGTTACACGG -> CAAGTAGTGAGTTACACGGG
ATCTATCAATTCGGTACTGA -> TCTATCAATTCGGTACTGAT
GGCATGGCTGATGATCTTGC -> GCATGGCTGATGATCTTGCG
ACTTCGTATTCGTGTAGTCT -> CTTCGTATTCGTGTAGTCTC
TTCGGTACTGATATCATGAA -> TCGGTACTGATATCATGAAA
GCTATAGTATCGACGGCTTA -> CTATAGTATCGACGGCTTAT
TCGTGGACTGTCTGAGGGAA -> CGTGGACTGTCTGAGGGAAT
CGGAGCCCGTGCGGAAGTAT -> GGAGCCCGTGCGGAAGTATT
TGATTAGGGTGTTGACGCCA -> GATTAGGGTGTTGACGCCAG
GGGTTTAAGCGCCACCTTCA -> GGTTTAAGCGCCACCTTCAA
CCGACGTGTCATGTACCAGG -> CGACGTGTCATGTACCAGGT
GGTCTTGCCTCAGACTCCCA -> GTCTTGCCTCAGACTCCCAG
GTAACATAAGGCCGAACAGC -> TAACATAAGGCCGAACAGCC
ACCATTCGATTCCATGCATT -> CCATTCGATTCCATGCATTG
TACCGCCCCGCGCCACATCA -> ACCGCCCCGCGCCACATCAG
CGAGAGAACCTGTAATGATC -> GAGAGAACCTGTAATGATCA
TCGCTAAACACCCGTTTGGT -> CGCTAAACACCCGTTTGGTC
CTCAGCACTCAACGGCATGG -> TCAGCACTCAACGGCATGGC
GCTACCTCAGCACTCAACGG -> CTACCTCAGCACTCAACGGC
TTGTCATCAATGACCATTCG -> TGTCATCAATGACCATTCGA
CTTCAACACCCGTACTCAAA -> TTCAACACCCGTACTCAAAT
TCTTGGATGTGGAGTAACAT -> CTTGGATGTGGAGTAACATA
TTATGCTACCTCAGCACTCA -> TATGCTACCTCAGCACTCAA
ATGAAACGAGAGGCGCGCGT -> TGAAACGAGAGGCGCGCGTA
AGATTCCTCGGAAGCATGAA -> GATTCCTCGGAAGCATGAAG
CCCATCCGCGCCGACGTGTC -> CCATCCGCGCCGACGTGTCA
CGGTACTGATATCATGAAAA -> GGTACTGATATCATGAAAAT
TAGAGATAACGTGCTGGCGG -> AGAGATAACGTGCTGGCGGC
GAACAGCCATTCCTGCGTAC -> AACAGCCATTCCTGCGTACG
ACTCGCGCACCCGTCGAGAG -> CTCGCGCACCCGTCGAGAGA
TTACCTACAACTCCCACGTA -> TACCTACAACTCCCACGTAA
GTTTGATTAGGGTGTTGACG -> TTTGATTAGGGTGTTGACGC
CGGCATGGCTGATGATCTTG -> GGCATGGCTGATGATCTTGC
AGCATGAAGGAAGTAGGCGG -> GCATGAAGGAAGTAGGCGGT
CATGTACCAGGTTACGAATG -> ATGTACCAGGTTACGAATGC
CCCAGATAATGAAACGAGAG -> CCAGATAATGAAACGAGAGG
CAGGTTACGAATGCTATTAC -> AGGTTACGAATGCTATTACC
TTGCCCATAAACTCGCGCAC -> TGCCCATAAACTCGCGCACC
GCCTCGGCATGAACGGACCA -> CCTCGGCATGAACGGACCAC
GTAACTCGAGATTCCTCGGA -> TAACTCGAGATTCCTCGGAA
CCAGTGGTTTCGATTGTCAT -> CAGTGGTTTCGATTGTCATC
TGGTCCCTACGCTTCGTAAA -> GGTCCCTACGCTTCGTAAAC
CATGGCTGATGATCTTGCGG -> ATGGCTGATGATCTTGCGGT
CTAAGGCCACATGCCAGCCG -> TAAGGCCACATGCCAGCCGG
ACAAGAGGGGTGTGATCTTG -> CAAGAGGGGTGTGATCTTGG
GAGGTTTAGCGTACACACCT -> AGGTTTAGCGTACACACCTA
TGATCTTGGATGTGGAGTAA -> GATCTTGGATGTGGAGTAAC
GGACCACTCCCATGTTGACT -> GACCACTCCCATGTTGACTA
CACCCGTTTGGTCCCTACGC -> ACCCGTTTGGTCCCTACGCT
GGAAGTATTCCTTAGACTCC -> GAAGTATTCCTTAGACTCCC
CAGACTCCCAGATAATGAAA -> AGACTCCCAGATAATGAAAC
TTTCCGGCCATGTCAAGGGG -> TTCCGGCCATGTCAAGGGGG
CGTAATTATGCCAGGTTTGC -> GTAATTATGCCAGGTTTGCA
ATGTCGTGGACTGTCTGAGG -> TGTCGTGGACTGTCTGAGGG
CCGGCGGGGGTCCAGTGGTT -> CGGCGGGGGTCCAGTGGTTT
TCGCGCACCCGTCGAGAGAA -> CGCGCACCCGTCGAGAGAAC
TGATACTAAGGCCACATGCC -> GATACTAAGGCCACATGCCA
ATGTGGAGTAACATAAGGCC -> TGTGGAGTAACATAAGGCCG
AACGAGAGGCGCGCGTAATT -> ACGAGAGGCGCGCGTAATTA
GGGGGTCCAGTGGTTTCGAT -> GGGGTCCAGTGGTTTCGATT
TATGCCAGGTTTGCAATACG -> ATGCCAGGTTTGCAATACGT
CCGAGGTTTAGCGTACACAC -> CGAGGTTTAGCGTACACACC
GAACCTGTAATGATCAGCAG -> AACCTGTAATGATCAGCAGA
AGACTCTAGAGATAACGTGC -> GACTCTAGAGATAACGTGCT
GCAGACAAGTACATGACACG -> CAGACAAGTACATGACACGT
GCCGGCGGGGGTCCAGTGGT -> CCGGCGGGGGTCCAGTGGTT
CGAGGTTTAGCGTACACACC -> GAGGTTTAGCGTACACACCT
ACAAGTACATGACACGTTCG -> CAAGTACATGACACGTTCGA
TACGCTTCGTAAACAGCTGT -> ACGCTTCGTAAACAGCTGTG
AACAGCTGTGTCCTCCGCTT -> ACAGCTGTGTCCTCCGCTTT
GCTTATGCTACCTCAGCACT -> CTTATGCTACCTCAGCACTC
TCCAGGTTGGACCCTGGGTT -> CCAGGTTGGACCCTGGGTTT
AGGTTACGAATGCTATTACC -> GGTTACGAATGCTATTACCT
CGGCAGACAAGTACATGACA -> GGCAGACAAGTACATGACAC
ATAGCTATAGTATCGACGGC -> TAGCTATAGTATCGACGGCT
CCATTCGATTCCATGCATTG -> CATTCGATTCCATGCATTGT
AGTAACTCGAGATTCCTCGG -> GTAACTCGAGATTCCTCGGA
CATTCCTGCGTACGCCGCCG -> ATTCCTGCGTACGCCGCCGG
ATCTTGCGGTCTTGCCTCAG -> TCTTGCGGTCTTGCCTCAGA
GTATGAGTGTTCATAGGTAA -> TATGAGTGTTCATAGGTAAA
ATCGACGGCTTATGCTACCT -> TCGACGGCTTATGCTACCTC
GTCACATGTGCCCATGTCGT -> TCACATGTGCCCATGTCGTG
GTACGCCGCCGGCGGGGGTC -> TACGCCGCCGGCGGGGGTCC
CCAGGTTGGACCCTGGGTTT -> CAGGTTGGACCCTGGGTTTA
ATGAACGGACCACTCCCATG -> TGAACGGACCACTCCCATGT
CTGCGTACGCCGCCGGCGGG -> TGCGTACGCCGCCGGCGGGG
GCGCCGACGTGTCATGTACC -> CGCCGACGTGTCATGTACCA
GGTTTGATTAGGGTGTTGAC -> GTTTGATTAGGGTGTTGACG
TGCTCGCGACACCAGGCTGA -> GCTCGCGACACCAGGCTGAT
CCATGTCGTGGACTGTCTGA -> CATGTCGTGGACTGTCTGAG
TGTACCAGGTTACGAATGCT -> GTACCAGGTTACGAATGCTA
TCGCGACACCAGGCTGATAC -> CGCGACACCAGGCTGATACT
GATAACGTGCTGGCGGCGAG -> ATAACGTGCTGGCGGCGAGT
CACGGGTGTGCCTCGGCATG -> ACGGGTGTGCCTCGGCATGA
GCCGAACAGCCATTCCTGCG -> CCGAACAGCCATTCCTGCGT
CGTAAATGTGTACGATCCGA -> GTAAATGTGTACGATCCGAG
CCGGAGCCCGTGCGGAAGTA -> CGGAGCCCGTGCGGAAGTAT
CCATAAACTCGCGCACCCGT -> CATAAACTCGCGCACCCGTC
TCTTGCCTCAGACTCCCAGA -> CTTGCCTCAGACTCCCAGAT
CGGTCTTGCCTCAGACTCCC -> GGTCTTGCCTCAGACTCCCA
CGTCACATGTGCCCATGTCG -> GTCACATGTGCCCATGTCGT
CACATGTGCCCATGTCGTGG -> ACATGTGCCCATGTCGTGGA
GTCAAGGGGGAGGTCTAAGG -> TCAAGGGGGAGGTCTAAGGT
TCATGCTCGCGACACCAGGC -> CATGCTCGCGACACCAGGCT
TTCGTTGCCCATAAACTCGC -> TCGTTGCCCATAAACTCGCG
ACGCCAGACACAAGAGGGGT -> CGCCAGACACAAGAGGGGTG
GCCACATCAGGATCCACTCC -> CCACATCAGGATCCACTCCA
TAGTGAGTTACACGGGTGTG -> AGTGAGTTACACGGGTGTGC
AGATAATGAAACGAGAGGCG -> GATAATGAAACGAGAGGCGC
TGCGTACGCCGCCGGCGGGG -> GCGTACGCCGCCGGCGGGGG
GGTATGAGTGTTCATAGGTA -> GTATGAGTGTTCATAGGTAA
TCATGTACCAGGTTACGAAT -> CATGTACCAGGTTACGAATG
GGATCCACTCCACAGGGTTA -> GATCCACTCCACAGGGTTAT
GTGTCCTCCGCTTTCCGGCC -> TGTCCTCCGCTTTCCGGCCA
ATTCCATGCATTGTCCTTTC -> TTCCATGCATTGTCCTTTCC
AGACTATTTCCCTCTCACGG -> GACTATTTCCCTCTCACGGG
AGGAAGTAGGCGGTCACTTA -> GGAAGTAGGCGGTCACTTAA
TTCCGGCCATGTCAAGGGGG -> TCCGGCCATGTCAAGGGGGA
GGCGGCGAGTAACTCGAGAT -> GCGGCGAGTAACTCGAGATT
ACTGTCTGAGGGAATGTCCA -> CTGTCTGAGGGAATGTCCAG
GGGTCCAGTGGTTTCGATTG -> GGTCCAGTGGTTTCGATTGT
CCCTGGGTTTAAGCGCCACC -> CCTGGGTTTAAGCGCCACCT
CCGCTTTCCGGCCATGTCAA -> CGCTTTCCGGCCATGTCAAG
TCGATTCCATGCATTGTCCT -> CGATTCCATGCATTGTCCTT
CACACCTAAGGCAAGTAGTG -> ACACCTAAGGCAAGTAGTGA
GAACGGACCACTCCCATGTT -> AACGGACCACTCCCATGTTG
TAGTCTCATGCTCGCGACAC -> AGTCTCATGCTCGCGACACC
AAATGTGTACGATCCGAGGT -> AATGTGTACGATCCGAGGTT
CACAAGAGGGGTGTGATCTT -> ACAAGAGGGGTGTGATCTTG
TACTGATATCATGAAAATGA -> ACTGATATCATGAAAATGAC
ATACTAAGGCCACATGCCAG -> TACTAAGGCCACATGCCAGC
GATCCACTCCACAGGGTTAT -> ATCCACTCCACAGGGTTATC
CTCACGGGTTTGATTAGGGT -> TCACGGGTTTGATTAGGGTG
TACTCAAATCTATCAATTCG -> ACTCAAATCTATCAATTCGG
CGGTCACTTAATAGCTATAG -> GGTCACTTAATAGCTATAGT
GTTCATAGGTAAATGGTGAG -> TTCATAGGTAAATGGTGAGT
GTGGAGTAACATAAGGCCGA -> TGGAGTAACATAAGGCCGAA
GCGGTCTTGCCTCAGACTCC -> CGGTCTTGCCTCAGACTCCC
GGCTGATGATCTTGCGGTCT -> GCTGATGATCTTGCGGTCTT
ACACGGGTGTGCCTCGGCAT -> CACGGGTGTGCCTCGGCATG
GACCACTCCCATGTTGACTA -> ACCACTCCCATGTTGACTAC
TCATGAAAATGACTTCGTAT -> CATGAAAATGACTTCGTATT
CCATCCGCGCCGACGTGTCA -> CATCCGCGCCGACGTGTCAT
TACGATCCGAGGTTTAGCGT -> ACGATCCGAGGTTTAGCGTA
AAGGCCACATGCCAGCCGGC -> AGGCCACATGCCAGCCGGCA
CAGATAATGAAACGAGAGGC -> AGATAATGAAACGAGAGGCG
CCAGGCTGATACTAAGGCCA -> CAGGCTGATACTAAGGCCAC
ATCCACTCCACAGGGTTATC -> TCCACTCCACAGGGTTATCG
TAAGGCCACATGCCAGCCGG -> AAGGCCACATGCCAGCCGGC
CGGGTTTGATTAGGGTGTTG -> GGGTTTGATTAGGGTGTTGA
TGTAATGATCAGCAGACAAC -> GTAATGATCAGCAGACAACT
TGTGTCCTCCGCTTTCCGGC -> GTGTCCTCCGCTTTCCGGCC
CTGTCTGAGGGAATGTCCAG -> TGTCTGAGGGAATGTCCAGG
CGATTCCATGCATTGTCCTT -> GATTCCATGCATTGTCCTTT
AGTGAGTTACACGGGTGTGC -> GTGAGTTACACGGGTGTGCC
GGTTTGCAATACGTCACATG -> GTTTGCAATACGTCACATGT
CACTCCCATGTTGACTACCG -> ACTCCCATGTTGACTACCGC
CGCTAAACACCCGTTTGGTC -> GCTAAACACCCGTTTGGTCC
TGACTTCGTATTCGTGTAGT -> GACTTCGTATTCGTGTAGTC
TGAAGGAAGTAGGCGGTCAC -> GAAGGAAGTAGGCGGTCACT
GCCCATGTCGTGGACTGTCT -> CCCATGTCGTGGACTGTCTG
GAAACGAGAGGCGCGCGTAA -> AAACGAGAGGCGCGCGTAAT
ATCAATGACCATTCGATTCC -> TCAATGACCATTCGATTCCA
TCCCTACGCTTCGTAAACAG -> CCCTACGCTTCGTAAACAGC
CGAACAGCCATTCCTGCGTA -> GAACAGCCATTCCTGCGTAC
TTCGATCGTCCCATCCGCGC -> TCGATCGTCCCATCCGCGCC
CATGTCAAGGGGGAGGTCTA -> ATGTCAAGGGGGAGGTCTAA
TGCCAGCCGGCAGACAAGTA -> GCCAGCCGGCAGACAAGTAC
ACTATTTCCCTCTCACGGGT -> CTATTTCCCTCTCACGGGTT
ATGTGCCCATGTCGTGGACT -> TGTGCCCATGTCGTGGACTG
CGCGCGTAATTATGCCAGGT -> GCGCGTAATTATGCCAGGTT
ATGAGTGTTCATAGGTAAAT -> TGAGTGTTCATAGGTAAATG
GCTGATACTAAGGCCACATG -> CTGATACTAAGGCCACATGC
TGTCCTCCGCTTTCCGGCCA -> GTCCTCCGCTTTCCGGCCAT
TGCATTGTCCTTTCCCGGAG -> GCATTGTCCTTTCCCGGAGC
AGCAGACAACTGAGACTATT -> GCAGACAACTGAGACTATTT
GAGAGGCGCGCGTAATTATG -> AGAGGCGCGCGTAATTATGC
TCAGCAGACAACTGAGACTA -> CAGCAGACAACTGAGACTAT
CTAAGGCAAGTAGTGAGTTA -> TAAGGCAAGTAGTGAGTTAC
GTACTGATATCATGAAAATG -> TACTGATATCATGAAAATGA
GTACATGACACGTTCGATCG -> TACATGACACGTTCGATCGT
TCAAGGGGGAGGTCTAAGGT -> CAAGGGGGAGGTCTAAGGTA
ACCGCCCCGCGCCACATCAG -> CCGCCCCGCGCCACATCAGG
CATCCGCGCCGACGTGTCAT -> ATCCGCGCCGACGTGTCATG
CAAATCTATCAATTCGGTAC -> AAATCTATCAATTCGGTACT
CTTATGCTACCTCAGCACTC -> TTATGCTACCTCAGCACTCA
GTGTGATCTTGGATGTGGAG -> TGTGATCTTGGATGTGGAGT
GTGTCATGTACCAGGTTACG -> TGTCATGTACCAGGTTACGA
GTTGCCCATAAACTCGCGCA -> TTGCCCATAAACTCGCGCAC
GGGAGGTCTAAGGTATGAGT -> GGAGGTCTAAGGTATGAGTG
CCTGTAATGATCAGCAGACA -> CTGTAATGATCAGCAGACAA
CAGGATCCACTCCACAGGGT -> AGGATCCACTCCACAGGGTT
GAGGGAATGTCCAGGTTGGA -> AGGGAATGTCCAGGTTGGAC
GCAGACAACTGAGACTATTT -> CAGACAACTGAGACTATTTC
CTAGAGATAACGTGCTGGCG -> TAGAGATAACGTGCTGGCGG
TAATGAAACGAGAGGCGCGC -> AATGAAACGAGAGGCGCGCG
TCGGAAGCATGAAGGAAGTA -> CGGAAGCATGAAGGAAGTAG
GTGGACTGTCTGAGGGAATG -> TGGACTGTCTGAGGGAATGT
CTCAGACTCCCAGATAATGA -> TCAGACTCCCAGATAATGAA
ACGCCGCCGGCGGGGGTCCA -> CGCCGCCGGCGGGGGTCCAG
CTTCGTAAACAGCTGTGTCC -> TTCGTAAACAGCTGTGTCCT
ACTCAAATCTATCAATTCGG -> CTCAAATCTATCAATTCGGT
CAGACACAAGAGGGGTGTGA -> AGACACAAGAGGGGTGTGAT
TTCGATTGTCATCAATGACC -> TCGATTGTCATCAATGACCA
CGTCGAGAGAACCTGTAATG -> GTCGAGAGAACCTGTAATGA
GCATGAAGGAAGTAGGCGGT -> CATGAAGGAAGTAGGCGGTC
GCCGACGTGTCATGTACCAG -> CCGACGTGTCATGTACCAGG
TACAACTCCCACGTAAATGT -> ACAACTCCCACGTAAATGTG
TATCGACGGCTTATGCTACC -> ATCGACGGCTTATGCTACCT
CGTGTCATGTACCAGGTTAC -> GTGTCATGTACCAGGTTACG
AATGACCATTCGATTCCATG -> ATGACCATTCGATTCCATGC
CCCGTCGAGAGAACCTGTAA -> CCGTCGAGAGAACCTGTAAT
CACCCGTACTCAAATCTATC -> ACCCGTACTCAAATCTATCA
CATGTGCCCATGTCGTGGAC -> ATGTGCCCATGTCGTGGACT
TCAAATCTATCAATTCGGTA -> CAAATCTATCAATTCGGTAC
GGGTGTTGACGCCAGACACA -> GGTGTTGACGCCAGACACAA
ATAGTATCGACGGCTTATGC -> TAGTATCGACGGCTTATGCT
TCACTTAATAGCTATAGTAT -> CACTTAATAGCTATAGTATC
GACGTGTCATGTACCAGGTT -> ACGTGTCATGTACCAGGTTA
CCATGTCAAGGGGGAGGTCT -> CATGTCAAGGGGGAGGTCTA
TCAACACCCGTACTCAAATC -> CAACACCCGTACTCAAATCT
GTGTAGTCTCATGCTCGCGA -> TGTAGTCTCATGCTCGCGAC
CAGCCATTCCTGCGTACGCC -> AGCCATTCCTGCGTACGCCG
ACGGCATGGCTGATGATCTT -> CGGCATGGCTGATGATCTTG
ATCCGAGGTTTAGCGTACAC -> TCCGAGGTTTAGCGTACACA
AATGAAACGAGAGGCGCGCG -> ATGAAACGAGAGGCGCGCGT
TGTTCATAGGTAAATGGTGA -> GTTCATAGGTAAATGGTGAG
GTTTGCAATACGTCACATGT -> TTTGCAATACGTCACATGTG
GACGGCTTATGCTACCTCAG -> ACGGCTTATGCTACCTCAGC
CACCCGTCGAGAGAACCTGT -> ACCCGTCGAGAGAACCTGTA
CAAGGGGGAGGTCTAAGGTA -> AAGGGGGAGGTCTAAGGTAT
CGGCCATGTCAAGGGGGAGG -> GGCCATGTCAAGGGGGAGGT
GCTGGCGGCGAGTAACTCGA -> CTGGCGGCGAGTAACTCGAG
CCACTCCACAGGGTTATCGC -> CACTCCACAGGGTTATCGCT
CTCCGCTTTCCGGCCATGTC -> TCCGCTTTCCGGCCATGTCA
AATGTGTACGATCCGAGGTT -> ATGTGTACGATCCGAGGTTT
GTTATCGCTAAACACCCGTT -> TTATCGCTAAACACCCGTTT
GAGGTCTAAGGTATGAGTGT -> AGGTCTAAGGTATGAGTGTT
ATTGTCCTTTCCCGGAGCCC -> TTGTCCTTTCCCGGAGCCCG
AGGGTTATCGCTAAACACCC -> GGGTTATCGCTAAACACCCG
CACTCAACGGCATGGCTGAT -> ACTCAACGGCATGGCTGATG
GCGGAAGTATTCCTTAGACT -> CGGAAGTATTCCTTAGACTC
TTAATAGCTATAGTATCGAC -> TAATAGCTATAGTATCGACG
TATAGTATCGACGGCTTATG -> ATAGTATCGACGGCTTATGC
CTCCCATGTTGACTACCGCC -> TCCCATGTTGACTACCGCCC
TGCTACCTCAGCACTCAACG -> GCTACCTCAGCACTCAACGG
GGTTACGAATGCTATTACCT -> GTTACGAATGCTATTACCTA
CTCAAATCTATCAATTCGGT -> TCAAATCTATCAATTCGGTA
GCGGGGGTCCAGTGGTTTCG -> CGGGGGTCCAGTGGTTTCGA
TGATCTTGCGGTCTTGCCTC -> GATCTTGCGGTCTTGCCTCA
GAGAGAACCTGTAATGATCA -> AGAGAACCTGTAATGATCAG
CTCCCAGATAATGAAACGAG -> TCCCAGATAATGAAACGAGA
GTCATGTACCAGGTTACGAA -> TCATGTACCAGGTTACGAAT
GATTGTCATCAATGACCATT -> ATTGTCATCAATGACCATTC
AGACACAAGAGGGGTGTGAT -> GACACAAGAGGGGTGTGATC
TTTGCAATACGTCACATGTG -> TTGCAATACGTCACATGTGC
GCGTACACACCTAAGGCAAG -> CGTACACACCTAAGGCAAGT
CAGCTGTGTCCTCCGCTTTC -> AGCTGTGTCCTCCGCTTTCC
TATCGCTAAACACCCGTTTG -> ATCGCTAAACACCCGTTTGG
TTCGTATTCGTGTAGTCTCA -> TCGTATTCGTGTAGTCTCAT
TACGAATGCTATTACCTACA -> ACGAATGCTATTACCTACAA
CTCGGCATGAACGGACCACT -> TCGGCATGAACGGACCACTC
GCCAGACACAAGAGGGGTGT -> CCAGACACAAGAGGGGTGTG
TTCCTTAGACTCCCGAGACT -> TCCTTAGACTCCCGAGACTC
TACCAGGTTACGAATGCTAT -> ACCAGGTTACGAATGCTATT
GTGTGCCTCGGCATGAACGG -> TGTGCCTCGGCATGAACGGA
CCAGACACAAGAGGGGTGTG -> CAGACACAAGAGGGGTGTGA
GCTAAACACCCGTTTGGTCC -> CTAAACACCCGTTTGGTCCC
TGACCATTCGATTCCATGCA -> GACCATTCGATTCCATGCAT
CGCACCCGTCGAGAGAACCT -> GCACCCGTCGAGAGAACCTG
AGACTCCCGAGACTCTAGAG -> GACTCCCGAGACTCTAGAGA
CATCAGGATCCACTCCACAG -> ATCAGGATCCACTCCACAGG
CGATCGTCCCATCCGCGCCG -> GATCGTCCCATCCGCGCCGA
GGATGTGGAGTAACATAAGG -> GATGTGGAGTAACATAAGGC
GCCGCCGGCGGGGGTCCAGT -> CCGCCGGCGGGGGTCCAGTG
CTCCACAGGGTTATCGCTAA -> TCCACAGGGTTATCGCTAAA
TGTCATCAATGACCATTCGA -> GTCATCAATGACCATTCGAT
CATGTTGACTACCGCCCCGC -> ATGTTGACTACCGCCCCGCG
ATGTCCAGGTTGGACCCTGG -> TGTCCAGGTTGGACCCTGGG
TGTCATGTACCAGGTTACGA -> GTCATGTACCAGGTTACGAA
GATCAGCAGACAACTGAGAC -> ATCAGCAGACAACTGAGACT
ACAGGGTTATCGCTAAACAC -> CAGGGTTATCGCTAAACACC
TGTCCAGGTTGGACCCTGGG -> GTCCAGGTTGGACCCTGGGT
CTGGGTTTAAGCGCCACCTT -> TGGGTTTAAGCGCCACCTTC
ATTCGTGTAGTCTCATGCTC -> TTCGTGTAGTCTCATGCTCG
ATGGCTGATGATCTTGCGGT -> TGGCTGATGATCTTGCGGTC
GAGGGGTGTGATCTTGGATG -> AGGGGTGTGATCTTGGATGT
ATGCCAGCCGGCAGACAAGT -> TGCCAGCCGGCAGACAAGTA
TGTCAAGGGGGAGGTCTAAG -> GTCAAGGGGGAGGTCTAAGG
AATCTATCAATTCGGTACTG -> ATCTATCAATTCGGTACTGA
CGCCGCCGGCGGGGGTCCAG -> GCCGCCGGCGGGGGTCCAGT
GGGTTTGATTAGGGTGTTGA -> GGTTTGATTAGGGTGTTGAC
CAGTGGTTTCGATTGTCATC -> AGTGGTTTCGATTGTCATCA
ACCACTCCCATGTTGACTAC -> CCACTCCCATGTTGACTACC
ATGACCATTCGATTCCATGC -> TGACCATTCGATTCCATGCA
ACACGTTCGATCGTCCCATC -> CACGTTCGATCGTCCCATCC
GTCACTTAATAGCTATAGTA -> TCACTTAATAGCTATAGTAT
TAAGGCCGAACAGCCATTCC -> AAGGCCGAACAGCCATTCCT
AAGTAGTGAGTTACACGGGT -> AGTAGTGAGTTACACGGGTG
CAATGACCATTCGATTCCAT -> AATGACCATTCGATTCCATG
GTTCGTTGCCCATAAACTCG -> TTCGTTGCCCATAAACTCGC
CCCGCGCCACATCAGGATCC -> CCGCGCCACATCAGGATCCA
GCATGGCTGATGATCTTGCG -> CATGGCTGATGATCTTGCGG
TCAATTCGGTACTGATATCA -> CAATTCGGTACTGATATCAT
GTTTGGTCCCTACGCTTCGT -> TTTGGTCCCTACGCTTCGTA
AGGCGCGCGTAATTATGCCA -> GGCGCGCGTAATTATGCCAG
ACTAAGGCCACATGCCAGCC -> CTAAGGCCACATGCCAGCCG
ATTCCTCGGAAGCATGAAGG -> TTCCTCGGAAGCATGAAGGA
GTACGATCCGAGGTTTAGCG -> TACGATCCGAGGTTTAGCGT
ACTGAGACTATTTCCCTCTC -> CTGAGACTATTTCCCTCTCA
TTAAGCGCCACCTTCAACAC -> TAAGCGCCACCTTCAACACC
TGAGGGAATGTCCAGGTTGG -> GAGGGAATGTCCAGGTTGGA
CTGATGATCTTGCGGTCTTG -> TGATGATCTTGCGGTCTTGC
GGCAGACAAGTACATGACAC -> GCAGACAAGTACATGACACG
TCGTATTCGTGTAGTCTCAT -> CGTATTCGTGTAGTCTCATG
CGAATGCTATTACCTACAAC -> GAATGCTATTACCTACAACT
AAGGCCGAACAGCCATTCCT -> AGGCCGAACAGCCATTCCTG
ACGGCTTATGCTACCTCAGC -> CGGCTTATGCTACCTCAGCA
TGTAGTCTCATGCTCGCGAC -> GTAGTCTCATGCTCGCGACA
AACCTGTAATGATCAGCAGA -> ACCTGTAATGATCAGCAGAC
TCCACTCCACAGGGTTATCG -> CCACTCCACAGGGTTATCGC
AACGGCATGGCTGATGATCT -> ACGGCATGGCTGATGATCTT
TGTGGAGTAACATAAGGCCG -> GTGGAGTAACATAAGGCCGA
GTAGGCGGTCACTTAATAGC -> TAGGCGGTCACTTAATAGCT
GAGAACCTGTAATGATCAGC -> AGAACCTGTAATGATCAGCA
CAGACAAGTACATGACACGT -> AGACAAGTACATGACACGTT
CCTACGCTTCGTAAACAGCT -> CTACGCTTCGTAAACAGCTG
CCGTTTGGTCCCTACGCTTC -> CGTTTGGTCCCTACGCTTCG
CAACGGCATGGCTGATGATC -> AACGGCATGGCTGATGATCT
CAGGGTTATCGCTAAACACC -> AGGGTTATCGCTAAACACCC
CCCGTTTGGTCCCTACGCTT -> CCGTTTGGTCCCTACGCTTC
TGTTGACTACCGCCCCGCGC -> GTTGACTACCGCCCCGCGCC
CGCCACCTTCAACACCCGTA -> GCCACCTTCAACACCCGTAC
CGAGATTCCTCGGAAGCATG -> GAGATTCCTCGGAAGCATGA
ACGGACCACTCCCATGTTGA -> CGGACCACTCCCATGTTGAC
ATTACCTACAACTCCCACGT -> TTACCTACAACTCCCACGTA
GGCGGTCACTTAATAGCTAT -> GCGGTCACTTAATAGCTATA
CACTCCACAGGGTTATCGCT -> ACTCCACAGGGTTATCGCTA
AATTATGCCAGGTTTGCAAT -> ATTATGCCAGGTTTGCAATA
AGACTCCCAGATAATGAAAC -> GACTCCCAGATAATGAAACG
GTCCTTTCCCGGAGCCCGTG -> TCCTTTCCCGGAGCCCGTGC
CCGTCGAGAGAACCTGTAAT -> CGTCGAGAGAACCTGTAATG
TGGACTGTCTGAGGGAATGT -> GGACTGTCTGAGGGAATGTC
ATCGTCCCATCCGCGCCGAC -> TCGTCCCATCCGCGCCGACG
GGTCCCTACGCTTCGTAAAC -> GTCCCTACGCTTCGTAAACA
AACGGACCACTCCCATGTTG -> ACGGACCACTCCCATGTTGA
TTCCTCGGAAGCATGAAGGA -> TCCTCGGAAGCATGAAGGAA
AATGCTATTACCTACAACTC -> ATGCTATTACCTACAACTCC
CCCATGTCGTGGACTGTCTG -> CCATGTCGTGGACTGTCTGA
CGTATTCGTGTAGTCTCATG -> GTATTCGTGTAGTCTCATGC
GTAATGATCAGCAGACAACT -> TAATGATCAGCAGACAACTG
CTATCAATTCGGTACTGATA -> TATCAATTCGGTACTGATAT
CTGAGGGAATGTCCAGGTTG -> TGAGGGAATGTCCAGGTTGG
GGTCTAAGGTATGAGTGTTC -> GTCTAAGGTATGAGTGTTCA
CCTGCGTACGCCGCCGGCGG -> CTGCGTACGCCGCCGGCGGG
CTTAATAGCTATAGTATCGA -> TTAATAGCTATAGTATCGAC
CCGCCCCGCGCCACATCAGG -> CGCCCCGCGCCACATCAGGA
CGTGTAGTCTCATGCTCGCG -> GTGTAGTCTCATGCTCGCGA
ACGTTCGATCGTCCCATCCG -> CGTTCGATCGTCCCATCCGC
AACGTGCTGGCGGCGAGTAA -> ACGTGCTGGCGGCGAGTAAC
ACGTCACATGTGCCCATGTC -> CGTCACATGTGCCCATGTCG
GTCTCATGCTCGCGACACCA -> TCTCATGCTCGCGACACCAG
AAATCTATCAATTCGGTACT -> AATCTATCAATTCGGTACTG
GCCGGCAGACAAGTACATGA -> CCGGCAGACAAGTACATGAC
GTCCAGGTTGGACCCTGGGT -> TCCAGGTTGGACCCTGGGTT
TTGACTACCGCCCCGCGCCA -> TGACTACCGCCCCGCGCCAC
ATAATGAAACGAGAGGCGCG -> TAATGAAACGAGAGGCGCGC
GCACCCGTCGAGAGAACCTG -> CACCCGTCGAGAGAACCTGT
TCTATCAATTCGGTACTGAT -> CTATCAATTCGGTACTGATA
AAAATGACTTCGTATTCGTG -> AAATGACTTCGTATTCGTGT
GCGCCACCTTCAACACCCGT -> CGCCACCTTCAACACCCGTA
TAAACAGCTGTGTCCTCCGC -> AAACAGCTGTGTCCTCCGCT
AGGGAATGTCCAGGTTGGAC -> GGGAATGTCCAGGTTGGACC
GCTGTGTCCTCCGCTTTCCG -> CTGTGTCCTCCGCTTTCCGG
TGGTTTCGATTGTCATCAAT -> GGTTTCGATTGTCATCAATG
ATAAGGCCGAACAGCCATTC -> TAAGGCCGAACAGCCATTCC
GTAGTGAGTTACACGGGTGT -> TAGTGAGTTACACGGGTGTG
AAGAGGGGTGTGATCTTGGA -> AGAGGGGTGTGATCTTGGAT
CACAGGGTTATCGCTAAACA -> ACAGGGTTATCGCTAAACAC
AGGCTGATACTAAGGCCACA -> GGCTGATACTAAGGCCACAT
ACCTAAGGCAAGTAGTGAGT -> CCTAAGGCAAGTAGTGAGTT
TCCATGCATTGTCCTTTCCC -> CCATGCATTGTCCTTTCCCG
TCTCATGCTCGCGACACCAG -> CTCATGCTCGCGACACCAGG
CATTCGATTCCATGCATTGT -> ATTCGATTCCATGCATTGTC
ACGTGTCATGTACCAGGTTA -> CGTGTCATGTACCAGGTTAC
TTCGTGTAGTCTCATGCTCG -> TCGTGTAGTCTCATGCTCGC
CATGAAAATGACTTCGTATT -> ATGAAAATGACTTCGTATTC
CGACGTGTCATGTACCAGGT -> GACGTGTCATGTACCAGGTT
CGGACCACTCCCATGTTGAC -> GGACCACTCCCATGTTGACT
ACTCCACAGGGTTATCGCTA -> CTCCACAGGGTTATCGCTAA
TCAGACTCCCAGATAATGAA -> CAGACTCCCAGATAATGAAA
GAGTGTTCATAGGTAAATGG -> AGTGTTCATAGGTAAATGGT
CATCAATGACCATTCGATTC -> ATCAATGACCATTCGATTCC
TTCGTAAACAGCTGTGTCCT -> TCGTAAACAGCTGTGTCCTC
CCCCGCGCCACATCAGGATC -> CCCGCGCCACATCAGGATCC
TATCAATTCGGTACTGATAT -> ATCAATTCGGTACTGATATC
TTTAAGCGCCACCTTCAACA -> TTAAGCGCCACCTTCAACAC
GACTCCCAGATAATGAAACG -> ACTCCCAGATAATGAAACGA
GATTCCATGCATTGTCCTTT -> ATTCCATGCATTGTCCTTTC
AGGCCGAACAGCCATTCCTG -> GGCCGAACAGCCATTCCTGC
TGCGGAAGTATTCCTTAGAC -> GCGGAAGTATTCCTTAGACT
GCAATACGTCACATGTGCCC -> CAATACGTCACATGTGCCCA
TAACGTGCTGGCGGCGAGTA -> AACGTGCTGGCGGCGAGTAA
AGTTACACGGGTGTGCCTCG -> GTTACACGGGTGTGCCTCGG
AGGTATGAGTGTTCATAGGT -> GGTATGAGTGTTCATAGGTA
AGTATCGACGGCTTATGCTA -> GTATCGACGGCTTATGCTAC
TACACACCTAAGGCAAGTAG -> ACACACCTAAGGCAAGTAGT
CGAGAGGCGCGCGTAATTAT -> GAGAGGCGCGCGTAATTATG
AAGTAGGCGGTCACTTAATA -> AGTAGGCGGTCACTTAATAG
TTGCGGTCTTGCCTCAGACT -> TGCGGTCTTGCCTCAGACTC
AGGGTGTTGACGCCAGACAC -> GGGTGTTGACGCCAGACACA
TAGGCGGTCACTTAATAGCT -> AGGCGGTCACTTAATAGCTA
ACCCGTCGAGAGAACCTGTA -> CCCGTCGAGAGAACCTGTAA
TCACATGTGCCCATGTCGTG -> CACATGTGCCCATGTCGTGG
TGGATGTGGAGTAACATAAG -> GGATGTGGAGTAACATAAGG
ACCTCAGCACTCAACGGCAT -> CCTCAGCACTCAACGGCATG
GATCGTCCCATCCGCGCCGA -> ATCGTCCCATCCGCGCCGAC
AACTGAGACTATTTCCCTCT -> ACTGAGACTATTTCCCTCTC
GAGTTACACGGGTGTGCCTC -> AGTTACACGGGTGTGCCTCG
ATGTTCGTTGCCCATAAACT -> TGTTCGTTGCCCATAAACTC
TGAAACGAGAGGCGCGCGTA -> GAAACGAGAGGCGCGCGTAA
TGATATCATGAAAATGACTT -> GATATCATGAAAATGACTTC
GAATGTCCAGGTTGGACCCT -> AATGTCCAGGTTGGACCCTG
TGCCCATAAACTCGCGCACC -> GCCCATAAACTCGCGCACCC
GGTTATCGCTAAACACCCGT -> GTTATCGCTAAACACCCGTT
GCCCATAAACTCGCGCACCC -> CCCATAAACTCGCGCACCCG
CCGGCAGACAAGTACATGAC -> CGGCAGACAAGTACATGACA
TCGATTGTCATCAATGACCA -> CGATTGTCATCAATGACCAT
TTGATTAGGGTGTTGACGCC -> TGATTAGGGTGTTGACGCCA
ACTCAACGGCATGGCTGATG -> CTCAACGGCATGGCTGATGA
AGCCGGCAGACAAGTACATG -> GCCGGCAGACAAGTACATGA
AAGGCAAGTAGTGAGTTACA -> AGGCAAGTAGTGAGTTACAC
CAATACGTCACATGTGCCCA -> AATACGTCACATGTGCCCAT
GAGCCCGTGCGGAAGTATTC -> AGCCCGTGCGGAAGTATTCC
ACTTAATAGCTATAGTATCG -> CTTAATAGCTATAGTATCGA
GTAGTCTCATGCTCGCGACA -> TAGTCTCATGCTCGCGACAC
ACATCAGGATCCACTCCACA -> CATCAGGATCCACTCCACAG
ACGTAAATGTGTACGATCCG -> CGTAAATGTGTACGATCCGA
CCCGTACTCAAATCTATCAA -> CCGTACTCAAATCTATCAAT
GCTATTACCTACAACTCCCA -> CTATTACCTACAACTCCCAC
GTAAATGTGTACGATCCGAG -> TAAATGTGTACGATCCGAGG
ATGTACCAGGTTACGAATGC -> TGTACCAGGTTACGAATGCT
CAACTGAGACTATTTCCCTC -> AACTGAGACTATTTCCCTCT
CATGACACGTTCGATCGTCC -> ATGACACGTTCGATCGTCCC
CGGAAGTATTCCTTAGACTC -> GGAAGTATTCCTTAGACTCC
GTTTCGATTGTCATCAATGA -> TTTCGATTGTCATCAATGAC
GTGTACGATCCGAGGTTTAG -> TGTACGATCCGAGGTTTAGC
GCCAGGTTTGCAATACGTCA -> CCAGGTTTGCAATACGTCAC
CCAGGTTTGCAATACGTCAC -> CAGGTTTGCAATACGTCACA
TCTTGCGGTCTTGCCTCAGA -> CTTGCGGTCTTGCCTCAGAC
CTCAACGGCATGGCTGATGA -> TCAACGGCATGGCTGATGAT
ACTCCCATGTTGACTACCGC -> CTCCCATGTTGACTACCGCC
TCCGGCCATGTCAAGGGGGA -> CCGGCCATGTCAAGGGGGAG
CCACCTTCAACACCCGTACT -> CACCTTCAACACCCGTACTC
GATTAGGGTGTTGACGCCAG -> ATTAGGGTGTTGACGCCAGA
CGTTCGATCGTCCCATCCGC -> GTTCGATCGTCCCATCCGCG
TCTGAGGGAATGTCCAGGTT -> CTGAGGGAATGTCCAGGTTG
TCCTCCGCTTTCCGGCCATG -> CCTCCGCTTTCCGGCCATGT
AAACTCGCGCACCCGTCGAG -> AACTCGCGCACCCGTCGAGA
GGCAAGTAGTGAGTTACACG -> GCAAGTAGTGAGTTACACGG
CGTACGCCGCCGGCGGGGGT -> GTACGCCGCCGGCGGGGGTC
GAGTAACATAAGGCCGAACA -> AGTAACATAAGGCCGAACAG
AAGGTATGAGTGTTCATAGG -> AGGTATGAGTGTTCATAGGT
TAGACTCCCGAGACTCTAGA -> AGACTCCCGAGACTCTAGAG
GGCTTATGCTACCTCAGCAC -> GCTTATGCTACCTCAGCACT
GACAAGTACATGACACGTTC -> ACAAGTACATGACACGTTCG
GCGCACCCGTCGAGAGAACC -> CGCACCCGTCGAGAGAACCT
GTCGTGGACTGTCTGAGGGA -> TCGTGGACTGTCTGAGGGAA
AAACGAGAGGCGCGCGTAAT -> AACGAGAGGCGCGCGTAATT
TTGACGCCAGACACAAGAGG -> TGACGCCAGACACAAGAGGG
GGGTGTGCCTCGGCATGAAC -> GGTGTGCCTCGGCATGAACG
TGCGGTCTTGCCTCAGACTC -> GCGGTCTTGCCTCAGACTCC
TTATCGCTAAACACCCGTTT -> TATCGCTAAACACCCGTTTG
TCGGTACTGATATCATGAAA -> CGGTACTGATATCATGAAAA
TACTAAGGCCACATGCCAGC -> ACTAAGGCCACATGCCAGCC
TCAGCACTCAACGGCATGGC -> CAGCACTCAACGGCATGGCT
GCCAGCCGGCAGACAAGTAC -> CCAGCCGGCAGACAAGTACA
GACTCTAGAGATAACGTGCT -> ACTCTAGAGATAACGTGCTG
GATCTTGGATGTGGAGTAAC -> ATCTTGGATGTGGAGTAACA
CCACATGCCAGCCGGCAGAC -> CACATGCCAGCCGGCAGACA
TCGAGATTCCTCGGAAGCAT -> CGAGATTCCTCGGAAGCATG
CGTGCGGAAGTATTCCTTAG -> GTGCGGAAGTATTCCTTAGA
CCCGAGACTCTAGAGATAAC -> CCGAGACTCTAGAGATAACG
GAATGCTATTACCTACAACT -> AATGCTATTACCTACAACTC
AATTCGGTACTGATATCATG -> ATTCGGTACTGATATCATGA
AACTCGAGATTCCTCGGAAG -> ACTCGAGATTCCTCGGAAGC
AGTCTCATGCTCGCGACACC -> GTCTCATGCTCGCGACACCA
ACGAGAGGCGCGCGTAATTA -> CGAGAGGCGCGCGTAATTAT
TGACACGTTCGATCGTCCCA -> GACACGTTCGATCGTCCCAT
AGGGGTGTGATCTTGGATGT -> GGGGTGTGATCTTGGATGTG
TACGCCGCCGGCGGGGGTCC -> ACGCCGCCGGCGGGGGTCCA
AGGGGGAGGTCTAAGGTATG -> GGGGGAGGTCTAAGGTATGA
CTCCCGAGACTCTAGAGATA -> TCCCGAGACTCTAGAGATAA
CTGAGACTATTTCCCTCTCA -> TGAGACTATTTCCCTCTCAC
ACACCTAAGGCAAGTAGTGA -> CACCTAAGGCAAGTAGTGAG
GGGTTATCGCTAAACACCCG -> GGTTATCGCTAAACACCCGT
CCTTAGACTCCCGAGACTCT -> CTTAGACTCCCGAGACTCTA
CGATTGTCATCAATGACCAT -> GATTGTCATCAATGACCATT
CATAAACTCGCGCACCCGTC -> ATAAACTCGCGCACCCGTCG
AAACAGCTGTGTCCTCCGCT -> AACAGCTGTGTCCTCCGCTT
GTACCAGGTTACGAATGCTA -> TACCAGGTTACGAATGCTAT
TGGAGTAACATAAGGCCGAA -> GGAGTAACATAAGGCCGAAC
GTTACACGGGTGTGCCTCGG -> TTACACGGGTGTGCCTCGGC
AGCACTCAACGGCATGGCTG -> GCACTCAACGGCATGGCTGA
TTGCCTCAGACTCCCAGATA -> TGCCTCAGACTCCCAGATAA
CCGCGCCGACGTGTCATGTA -> CGCGCCGACGTGTCATGTAC
TCCGCTTTCCGGCCATGTCA -> CCGCTTTCCGGCCATGTCAA
AAGCGCCACCTTCAACACCC -> AGCGCCACCTTCAACACCCG
CACATGCCAGCCGGCAGACA -> ACATGCCAGCCGGCAGACAA
GTACACACCTAAGGCAAGTA -> TACACACCTAAGGCAAGTAG
AGGTTTGCAATACGTCACAT -> GGTTTGCAATACGTCACATG
GTTGACTACCGCCCCGCGCC -> TTGACTACCGCCCCGCGCCA
TTATGCCAGGTTTGCAATAC -> TATGCCAGGTTTGCAATACG
CCCGGAGCCCGTGCGGAAGT -> CCGGAGCCCGTGCGGAAGTA
ACAACTCCCACGTAAATGTG -> CAACTCCCACGTAAATGTGT
CTCGGAAGCATGAAGGAAGT -> TCGGAAGCATGAAGGAAGTA
GACCATTCGATTCCATGCAT -> ACCATTCGATTCCATGCATT
GTGCCCATGTCGTGGACTGT -> TGCCCATGTCGTGGACTGTC
GAAGTAGGCGGTCACTTAAT -> AAGTAGGCGGTCACTTAATA
TCCCACGTAAATGTGTACGA -> CCCACGTAAATGTGTACGAT
AGTACATGACACGTTCGATC -> GTACATGACACGTTCGATCG
CAAGAGGGGTGTGATCTTGG -> AAGAGGGGTGTGATCTTGGA
GTGTTGACGCCAGACACAAG -> TGTTGACGCCAGACACAAGA
CCCATGTTGACTACCGCCCC -> CCATGTTGACTACCGCCCCG
GATCCGAGGTTTAGCGTACA -> ATCCGAGGTTTAGCGTACAC
AAATGACTTCGTATTCGTGT -> AATGACTTCGTATTCGTGTA
GCGACACCAGGCTGATACTA -> CGACACCAGGCTGATACTAA
GTTGACGCCAGACACAAGAG -> TTGACGCCAGACACAAGAGG
CGGAAGCATGAAGGAAGTAG -> GGAAGCATGAAGGAAGTAGG
GATGTGGAGTAACATAAGGC -> ATGTGGAGTAACATAAGGCC
CTCGCGCACCCGTCGAGAGA -> TCGCGCACCCGTCGAGAGAA
ACATGACACGTTCGATCGTC -> CATGACACGTTCGATCGTCC
ACACCAGGCTGATACTAAGG -> CACCAGGCTGATACTAAGGC
GAAAATGACTTCGTATTCGT -> AAAATGACTTCGTATTCGTG
GGTCCAGTGGTTTCGATTGT -> GTCCAGTGGTTTCGATTGTC
ACCTGTAATGATCAGCAGAC -> CCTGTAATGATCAGCAGACA
TGATCAGCAGACAACTGAGA -> GATCAGCAGACAACTGAGAC
AGAGGCGCGCGTAATTATGC -> GAGGCGCGCGTAATTATGCC
ATTCCTTAGACTCCCGAGAC -> TTCCTTAGACTCCCGAGACT
AGGTCTAAGGTATGAGTGTT -> GGTCTAAGGTATGAGTGTTC
ATTAGGGTGTTGACGCCAGA -> TTAGGGTGTTGACGCCAGAC
GGTTTAGCGTACACACCTAA -> GTTTAGCGTACACACCTAAG
CCACGTAAATGTGTACGATC -> CACGTAAATGTGTACGATCC
TTGTCCTTTCCCGGAGCCCG -> TGTCCTTTCCCGGAGCCCGT
TCCGAGGTTTAGCGTACACA -> CCGAGGTTTAGCGTACACAC
CAGCCGGCAGACAAGTACAT -> AGCCGGCAGACAAGTACATG
AACACCCGTTTGGTCCCTAC -> ACACCCGTTTGGTCCCTACG
ATTTCCCTCTCACGGGTTTG -> TTTCCCTCTCACGGGTTTGA
CGGGGGTCCAGTGGTTTCGA -> GGGGGTCCAGTGGTTTCGAT
TCGTCCCATCCGCGCCGACG -> CGTCCCATCCGCGCCGACGT
TGTCCTTTCCCGGAGCCCGT -> GTCCTTTCCCGGAGCCCGTG
TCCCAGATAATGAAACGAGA -> CCCAGATAATGAAACGAGAG
TGAGACTATTTCCCTCTCAC -> GAGACTATTTCCCTCTCACG
TCGACGGCTTATGCTACCTC -> CGACGGCTTATGCTACCTCA
TCGATCGTCCCATCCGCGCC -> CGATCGTCCCATCCGCGCCG
ATCAGGATCCACTCCACAGG -> TCAGGATCCACTCCACAGGG
ATTATGCCAGGTTTGCAATA -> TTATGCCAGGTTTGCAATAC
CTCTAGAGATAACGTGCTGG -> TCTAGAGATAACGTGCTGGC
ATGACTTCGTATTCGTGTAG -> TGACTTCGTATTCGTGTAGT
TCTAGAGATAACGTGCTGGC -> CTAGAGATAACGTGCTGGCG
ATCGCTAAACACCCGTTTGG -> TCGCTAAACACCCGTTTGGT
TATGCTACCTCAGCACTCAA -> ATGCTACCTCAGCACTCAAC
GGAGCCCGTGCGGAAGTATT -> GAGCCCGTGCGGAAGTATTC
GCATTGTCCTTTCCCGGAGC -> CATTGTCCTTTCCCGGAGCC
TATCATGAAAATGACTTCGT -> ATCATGAAAATGACTTCGTA
AATGTCCAGGTTGGACCCTG -> ATGTCCAGGTTGGACCCTGG
CCCTCTCACGGGTTTGATTA -> CCTCTCACGGGTTTGATTAG
CAGCACTCAACGGCATGGCT -> AGCACTCAACGGCATGGCTG
AGAGAACCTGTAATGATCAG -> GAGAACCTGTAATGATCAGC
TCGTAAACAGCTGTGTCCTC -> CGTAAACAGCTGTGTCCTCC
CGCGCACCCGTCGAGAGAAC -> GCGCACCCGTCGAGAGAACC
CCGCGCCACATCAGGATCCA -> CGCGCCACATCAGGATCCAC
AATACGTCACATGTGCCCAT -> ATACGTCACATGTGCCCATG
GACACCAGGCTGATACTAAG -> ACACCAGGCTGATACTAAGG
TGCCCATGTCGTGGACTGTC -> GCCCATGTCGTGGACTGTCT
AACATAAGGCCGAACAGCCA -> ACATAAGGCCGAACAGCCAT
GCGCGTAATTATGCCAGGTT -> CGCGTAATTATGCCAGGTTT
GTTTAAGCGCCACCTTCAAC -> TTTAAGCGCCACCTTCAACA
CACATCAGGATCCACTCCAC -> ACATCAGGATCCACTCCACA
TCCCTCTCACGGGTTTGATT -> CCCTCTCACGGGTTTGATTA
CAGGTTTGCAATACGTCACA -> AGGTTTGCAATACGTCACAT
CATGCTCGCGACACCAGGCT -> ATGCTCGCGACACCAGGCTG
GGTGTTGACGCCAGACACAA -> GTGTTGACGCCAGACACAAG
CATGCCAGCCGGCAGACAAG -> ATGCCAGCCGGCAGACAAGT
GGGTGTGATCTTGGATGTGG -> GGTGTGATCTTGGATGTGGA
ACCCGTTTGGTCCCTACGCT -> CCCGTTTGGTCCCTACGCTT
GCGCGCGTAATTATGCCAGG -> CGCGCGTAATTATGCCAGGT
TAAACACCCGTTTGGTCCCT -> AAACACCCGTTTGGTCCCTA
TGACTACCGCCCCGCGCCAC -> GACTACCGCCCCGCGCCACA
TAGTATCGACGGCTTATGCT -> AGTATCGACGGCTTATGCTA
GCCACATGCCAGCCGGCAGA -> CCACATGCCAGCCGGCAGAC
GATAATGAAACGAGAGGCGC -> ATAATGAAACGAGAGGCGCG
CCGGCCATGTCAAGGGGGAG -> CGGCCATGTCAAGGGGGAGG
GTCCAGTGGTTTCGATTGTC -> TCCAGTGGTTTCGATTGTCA
GATTCCTCGGAAGCATGAAG -> ATTCCTCGGAAGCATGAAGG
ACACCCGTTTGGTCCCTACG -> CACCCGTTTGGTCCCTACGC
CTAAGGTATGAGTGTTCATA -> TAAGGTATGAGTGTTCATAG
TAAGGTATGAGTGTTCATAG -> AAGGTATGAGTGTTCATAGG
CAGGTTGGACCCTGGGTTTA -> AGGTTGGACCCTGGGTTTAA
AGCCATTCCTGCGTACGCCG -> GCCATTCCTGCGTACGCCGC
GCCCCGCGCCACATCAGGAT -> CCCCGCGCCACATCAGGATC
CGACGGCTTATGCTACCTCA -> GACGGCTTATGCTACCTCAG
GGGAATGTCCAGGTTGGACC -> GGAATGTCCAGGTTGGACCC
CAAGTACATGACACGTTCGA -> AAGTACATGACACGTTCGAT
AGAGATAACGTGCTGGCGGC -> GAGATAACGTGCTGGCGGCG
CGCCCCGCGCCACATCAGGA -> GCCCCGCGCCACATCAGGAT
TGCTGGCGGCGAGTAACTCG -> GCTGGCGGCGAGTAACTCGA
GATATCATGAAAATGACTTC -> ATATCATGAAAATGACTTCG
GGCGCGCGTAATTATGCCAG -> GCGCGCGTAATTATGCCAGG
TTCATAGGTAAATGGTGAGT -> TCATAGGTAAATGGTGAGTC
AGCTGTGTCCTCCGCTTTCC -> GCTGTGTCCTCCGCTTTCCG
CCCACGTAAATGTGTACGAT -> CCACGTAAATGTGTACGATC
GTCATCAATGACCATTCGAT -> TCATCAATGACCATTCGATT
CATGTCGTGGACTGTCTGAG -> ATGTCGTGGACTGTCTGAGG
GTTGGACCCTGGGTTTAAGC -> TTGGACCCTGGGTTTAAGCG
ACGAATGCTATTACCTACAA -> CGAATGCTATTACCTACAAC
TAGGGTGTTGACGCCAGACA -> AGGGTGTTGACGCCAGACAC
GGCATGAACGGACCACTCCC -> GCATGAACGGACCACTCCCA
CCGTGCGGAAGTATTCCTTA -> CGTGCGGAAGTATTCCTTAG
TCCCGGAGCCCGTGCGGAAG -> CCCGGAGCCCGTGCGGAAGT
CACGTAAATGTGTACGATCC -> ACGTAAATGTGTACGATCCG
GAGACTCTAGAGATAACGTG -> AGACTCTAGAGATAACGTGC
AAGTACATGACACGTTCGAT -> AGTACATGACACGTTCGATC
CCACAGGGTTATCGCTAAAC -> CACAGGGTTATCGCTAAACA
GGTGTGATCTTGGATGTGGA -> GTGTGATCTTGGATGTGGAG
ATCTTGGATGTGGAGTAACA -> TCTTGGATGTGGAGTAACAT
AGTGGTTTCGATTGTCATCA -> GTGGTTTCGATTGTCATCAA
TGGGTTTAAGCGCCACCTTC -> GGGTTTAAGCGCCACCTTCA
AAGGAAGTAGGCGGTCACTT -> AGGAAGTAGGCGGTCACTTA
CGCTTTCCGGCCATGTCAAG -> GCTTTCCGGCCATGTCAAGG
CGGGTGTGCCTCGGCATGAA -> GGGTGTGCCTCGGCATGAAC
CTGATATCATGAAAATGACT -> TGATATCATGAAAATGACTT
GTGCCTCGGCATGAACGGAC -> TGCCTCGGCATGAACGGACC
ATTCCTGCGTACGCCGCCGG -> TTCCTGCGTACGCCGCCGGC
TTCCATGCATTGTCCTTTCC -> TCCATGCATTGTCCTTTCCC
AATGACTTCGTATTCGTGTA -> ATGACTTCGTATTCGTGTAG
ATGCTACCTCAGCACTCAAC -> TGCTACCTCAGCACTCAACG
AACTCGCGCACCCGTCGAGA -> ACTCGCGCACCCGTCGAGAG
CTCTCACGGGTTTGATTAGG -> TCTCACGGGTTTGATTAGGG
ATGACACGTTCGATCGTCCC -> TGACACGTTCGATCGTCCCA
CCTCGGCATGAACGGACCAC -> CTCGGCATGAACGGACCACT
CATGAACGGACCACTCCCAT -> ATGAACGGACCACTCCCATG
TAGCGTACACACCTAAGGCA -> AGCGTACACACCTAAGGCAA
CATGAAGGAAGTAGGCGGTC -> ATGAAGGAAGTAGGCGGTCA
GTAAACAGCTGTGTCCTCCG -> TAAACAGCTGTGTCCTCCGC
CAGACAACTGAGACTATTTC -> AGACAACTGAGACTATTTCC
CGCGTAATTATGCCAGGTTT -> GCGTAATTATGCCAGGTTTG
GGGGAGGTCTAAGGTATGAG -> GGGAGGTCTAAGGTATGAGT
GTCCCTACGCTTCGTAAACA -> TCCCTACGCTTCGTAAACAG
GTCGAGAGAACCTGTAATGA -> TCGAGAGAACCTGTAATGAT
AGGCAAGTAGTGAGTTACAC -> GGCAAGTAGTGAGTTACACG
GGCCGAACAGCCATTCCTGC -> GCCGAACAGCCATTCCTGCG
CAACTCCCACGTAAATGTGT -> AACTCCCACGTAAATGTGTA
GGAATGTCCAGGTTGGACCC -> GAATGTCCAGGTTGGACCCT
CGAGTAACTCGAGATTCCTC -> GAGTAACTCGAGATTCCTCG
CGGCTTATGCTACCTCAGCA -> GGCTTATGCTACCTCAGCAC
CGCCACATCAGGATCCACTC -> GCCACATCAGGATCCACTCC
CCTCAGCACTCAACGGCATG -> CTCAGCACTCAACGGCATGG
GGAGTAACATAAGGCCGAAC -> GAGTAACATAAGGCCGAACA
GCGAGTAACTCGAGATTCCT -> CGAGTAACTCGAGATTCCTC
TCACGGGTTTGATTAGGGTG -> CACGGGTTTGATTAGGGTGT
TACCTACAACTCCCACGTAA -> ACCTACAACTCCCACGTAAA
AGTAGGCGGTCACTTAATAG -> GTAGGCGGTCACTTAATAGC
CCCGTGCGGAAGTATTCCTT -> CCGTGCGGAAGTATTCCTTA
CGCCGGCGGGGGTCCAGTGG -> GCCGGCGGGGGTCCAGTGGT
AGTATTCCTTAGACTCCCGA -> GTATTCCTTAGACTCCCGAG
AACACCCGTACTCAAATCTA -> ACACCCGTACTCAAATCTAT
AGATAACGTGCTGGCGGCGA -> GATAACGTGCTGGCGGCGAG
GAGTAACTCGAGATTCCTCG -> AGTAACTCGAGATTCCTCGG
TCCCATGTTGACTACCGCCC -> CCCATGTTGACTACCGCCCC
GAAGTATTCCTTAGACTCCC -> AAGTATTCCTTAGACTCCCG
AGTAACATAAGGCCGAACAG -> GTAACATAAGGCCGAACAGC
GACGCCAGACACAAGAGGGG -> ACGCCAGACACAAGAGGGGT
GTCCCATCCGCGCCGACGTG -> TCCCATCCGCGCCGACGTGT
GTATCGACGGCTTATGCTAC -> TATCGACGGCTTATGCTACC
GTACTCAAATCTATCAATTC -> TACTCAAATCTATCAATTCG
TATTACCTACAACTCCCACG -> ATTACCTACAACTCCCACGT
TAACTCGAGATTCCTCGGAA -> AACTCGAGATTCCTCGGAAG
TCATAGGTAAATGGTGAGTC -> CATAGGTAAATGGTGAGTCT
CTGGCGGCGAGTAACTCGAG -> TGGCGGCGAGTAACTCGAGA
ACGTGCTGGCGGCGAGTAAC -> CGTGCTGGCGGCGAGTAACT
TAAACTCGCGCACCCGTCGA -> AAACTCGCGCACCCGTCGAG
TCTCACGGGTTTGATTAGGG -> CTCACGGGTTTGATTAGGGT
GGAAGTAGGCGGTCACTTAA -> GAAGTAGGCGGTCACTTAAT
GTGAGTTACACGGGTGTGCC -> TGAGTTACACGGGTGTGCCT
TTTGATTAGGGTGTTGACGC -> TTGATTAGGGTGTTGACGCC
ACAACTGAGACTATTTCCCT -> CAACTGAGACTATTTCCCTC
TTCAACACCCGTACTCAAAT -> TCAACACCCGTACTCAAATC
ATCCGCGCCGACGTGTCATG -> TCCGCGCCGACGTGTCATGT
TCATCAATGACCATTCGATT -> CATCAATGACCATTCGATTC
GAGGCGCGCGTAATTATGCC -> AGGCGCGCGTAATTATGCCA
GCTTTCCGGCCATGTCAAGG -> CTTTCCGGCCATGTCAAGGG
TGATGATCTTGCGGTCTTGC -> GATGATCTTGCGGTCTTGCC
GTTTAGCGTACACACCTAAG -> TTTAGCGTACACACCTAAGG
ATGAAGGAAGTAGGCGGTCA -> TGAAGGAAGTAGGCGGTCAC
CGGCGGGGGTCCAGTGGTTT -> GGCGGGGGTCCAGTGGTTTC
GAGATAACGTGCTGGCGGCG -> AGATAACGTGCTGGCGGCGA
CCTGGGTTTAAGCGCCACCT -> CTGGGTTTAAGCGCCACCTT
GACACGTTCGATCGTCCCAT -> ACACGTTCGATCGTCCCATC
GACTGTCTGAGGGAATGTCC -> ACTGTCTGAGGGAATGTCCA
TCAACGGCATGGCTGATGAT -> CAACGGCATGGCTGATGATC
ACAGCTGTGTCCTCCGCTTT -> CAGCTGTGTCCTCCGCTTTC
TTTAGCGTACACACCTAAGG -> TTAGCGTACACACCTAAGGC
CAATTCGGTACTGATATCAT -> AATTCGGTACTGATATCATG
GGTGTGCCTCGGCATGAACG -> GTGTGCCTCGGCATGAACGG
GCCACCTTCAACACCCGTAC -> CCACCTTCAACACCCGTACT
CTCGAGATTCCTCGGAAGCA -> TCGAGATTCCTCGGAAGCAT
TCCACAGGGTTATCGCTAAA -> CCACAGGGTTATCGCTAAAC
CTGTGTCCTCCGCTTTCCGG -> TGTGTCCTCCGCTTTCCGGC
ATTCGGTACTGATATCATGA -> TTCGGTACTGATATCATGAA
TGGCGGCGAGTAACTCGAGA -> GGCGGCGAGTAACTCGAGAT
ATGCTCGCGACACCAGGCTG -> TGCTCGCGACACCAGGCTGA
ACGATCCGAGGTTTAGCGTA -> CGATCCGAGGTTTAGCGTAC
TTACGAATGCTATTACCTAC -> TACGAATGCTATTACCTACA
CTACGCTTCGTAAACAGCTG -> TACGCTTCGTAAACAGCTGT
CCACTCCCATGTTGACTACC -> CACTCCCATGTTGACTACCG
TTTCCCTCTCACGGGTTTGA -> TTCCCTCTCACGGGTTTGAT
ACTCTAGAGATAACGTGCTG -> CTCTAGAGATAACGTGCTGG
